price,bedrooms,bathrooms,sqft_living,floors,view,sqft_above,sqft_basement
313000.0,3.0,1.5,1340,1.5,0,1340,0
342000.0,3.0,2.0,1930,1.0,0,1930,0
420000.0,3.0,2.25,2000,1.0,0,1000,1000
550000.0,4.0,2.5,1940,1.0,0,1140,800
490000.0,2.0,1.0,880,1.0,0,880,0
335000.0,2.0,2.0,1350,1.0,0,1350,0
482000.0,4.0,2.5,2710,2.0,0,2710,0
640000.0,4.0,2.0,1520,1.5,0,1520,0
463000.0,3.0,1.75,1710,1.0,0,1710,0
588500.0,3.0,1.75,2330,1.0,0,1970,360
365000.0,3.0,1.0,1090,1.0,0,1090,0
1200000.0,5.0,2.75,2910,1.5,0,2910,0
242500.0,3.0,1.5,1200,1.0,0,1200,0
419000.0,3.0,1.5,1570,1.0,0,1570,0
367500.0,4.0,3.0,3110,2.0,0,3110,0
257950.0,3.0,1.75,1370,1.0,0,1370,0
275000.0,3.0,1.5,1180,1.0,0,1180,0
750000.0,3.0,1.75,2240,2.0,0,1550,690
435000.0,4.0,1.0,1450,1.0,0,1450,0
626000.0,3.0,2.25,1750,2.5,0,1470,280
612500.0,4.0,2.5,2730,2.0,0,2730,0
495000.0,4.0,1.75,1600,1.0,0,1130,470
285000.0,3.0,2.5,2090,1.0,0,1360,730
615000.0,3.0,1.75,2360,1.0,0,1360,1000
698000.0,4.0,2.25,2200,1.5,0,1300,900
790000.0,3.0,2.5,2600,1.0,0,1700,900
382500.0,4.0,1.75,1560,1.0,0,1560,0
499950.0,4.0,2.5,2860,2.0,0,2190,670
650000.0,4.0,2.0,1820,1.5,1,1640,180
625000.0,4.0,2.5,2820,2.0,0,2820,0
400000.0,4.0,2.5,3630,1.5,0,2300,1330
604000.0,3.0,2.5,3240,2.0,2,3240,0
440000.0,2.0,1.0,800,1.0,0,800,0
287200.0,3.0,3.0,1850,1.0,0,1090,760
403000.0,3.0,2.0,1960,1.0,2,1650,310
750000.0,3.0,2.5,2390,1.0,2,1440,950
335000.0,3.0,2.25,1580,1.0,0,1580,0
260000.0,4.0,2.0,1480,1.0,0,1480,0
308500.0,2.0,1.0,850,1.0,0,850,0
439950.0,3.0,2.5,1770,2.0,0,1770,0
235000.0,2.0,1.0,1210,1.0,0,1210,0
315000.0,3.0,1.0,1160,1.0,0,1160,0
437500.0,3.0,2.25,1970,2.0,0,1970,0
407500.0,3.0,2.5,1930,2.0,0,1930,0
445700.0,3.0,2.5,1270,3.0,0,1270,0
838000.0,4.0,2.5,3310,2.0,0,3310,0
630000.0,4.0,2.75,2710,2.0,0,2710,0
550000.0,3.0,1.75,2910,1.5,0,2910,0
805000.0,3.0,2.0,2710,1.5,0,1880,830
284000.0,3.0,1.75,1800,1.0,0,1800,0
470000.0,5.0,2.5,2210,1.0,0,1460,750
430000.0,4.0,1.5,1920,1.0,0,1070,850
785000.0,5.0,3.25,3660,2.0,2,3660,0
385000.0,3.0,3.25,1320,2.0,0,1040,280
295000.0,2.0,2.5,1630,2.0,0,1280,350
555000.0,4.0,2.5,3310,2.0,0,3310,0
459990.0,3.0,2.5,2680,2.0,0,2680,0
300000.0,3.0,2.5,2540,2.0,0,2540,0
625000.0,4.0,2.75,2920,2.0,0,2920,0
553000.0,2.0,1.0,900,1.0,0,900,0
379880.0,3.0,2.5,1650,1.0,0,1130,520
310000.0,3.0,1.0,1010,1.0,0,1010,0
775000.0,2.0,2.5,2680,1.0,0,2680,0
365000.0,3.0,2.5,2200,1.0,0,1570,630
331950.0,4.0,2.5,2530,2.0,2,2010,520
783500.0,3.0,2.5,2850,2.0,0,1990,860
628000.0,4.0,2.0,2280,1.0,0,1140,1140
560000.0,3.0,2.5,1900,2.0,0,1900,0
531000.0,2.0,3.0,1270,2.0,0,1110,160
831000.0,4.0,3.0,2170,2.0,0,1610,560
780000.0,4.0,2.5,2730,2.0,2,2730,0
755000.0,4.0,2.5,2120,1.0,0,1620,500
705380.0,3.0,2.5,2490,2.0,0,2490,0
627000.0,4.0,2.25,1990,1.0,0,1210,780
865000.0,4.0,3.0,3690,2.0,0,3690,0
580000.0,2.0,1.0,2540,1.0,0,1320,1220
410000.0,3.0,2.25,1800,1.0,0,1360,440
485000.0,4.0,3.0,2340,1.0,0,1340,1000
400000.0,2.0,1.75,2110,1.0,0,2110,0
549000.0,2.0,1.0,1140,1.0,0,1140,0
620000.0,3.0,1.75,1480,2.5,0,1480,0
405000.0,2.0,3.0,1410,2.0,0,1140,270
232000.0,2.0,1.0,1200,1.0,0,1200,0
800866.0,5.0,2.5,3180,2.0,0,3180,0
650000.0,3.0,1.5,2160,1.0,2,1400,760
770000.0,3.0,2.0,2350,1.5,0,1810,540
524000.0,3.0,1.75,1560,1.0,0,780,780
541125.0,5.0,2.75,2740,1.0,0,1370,1370
670000.0,3.0,2.5,1680,3.0,0,1680,0
384900.0,5.0,2.5,3090,1.0,0,1750,1340
406100.0,3.0,2.25,1410,3.0,0,1410,0
736500.0,4.0,2.5,3180,2.0,3,3180,0
570000.0,3.0,2.25,2010,1.0,0,1330,680
787000.0,3.0,1.75,1330,1.0,0,1330,0
328000.0,4.0,2.5,2370,2.0,0,2370,0
435000.0,5.0,2.0,1840,1.0,0,1540,300
499000.0,4.0,2.5,2910,2.0,0,2910,0
501000.0,4.0,1.0,2070,1.0,0,1160,910
400000.0,2.0,1.0,840,1.0,0,840,0
220000.0,4.0,1.5,1240,1.0,0,1240,0
657100.0,4.0,1.0,1390,1.0,0,1050,340
309950.0,4.0,2.75,2310,2.0,0,2310,0
300000.0,3.0,2.0,1050,1.0,0,1050,0
740000.0,4.0,1.75,2010,1.5,0,2010,0
340000.0,5.0,1.0,1120,1.5,0,1120,0
398750.0,3.0,2.5,2230,2.0,0,2230,0
206000.0,2.0,1.0,810,1.0,0,810,0
1030000.0,5.0,2.75,3190,1.0,3,1690,1500
600000.0,3.0,1.75,1670,1.0,0,1670,0
379950.0,4.0,1.75,1970,1.0,0,1140,830
287000.0,3.0,1.0,1450,1.0,0,1450,0
309950.0,3.0,2.5,1880,2.0,0,1880,0
600000.0,3.0,1.75,1880,1.0,0,1040,840
418000.0,3.0,2.0,1410,1.5,0,1410,0
449250.0,4.0,2.0,1480,1.5,0,1480,0
329950.0,2.0,1.0,1140,1.5,0,1140,0
245000.0,3.0,1.75,1920,1.0,0,1000,920
549000.0,4.0,2.5,2910,2.0,0,2910,0
800000.0,3.0,2.5,3240,2.0,0,3240,0
249950.0,3.0,2.0,1550,1.0,0,1550,0
210000.0,5.0,2.0,2050,1.0,0,1430,620
585000.0,2.0,1.0,1770,1.5,0,1520,250
615000.0,4.0,1.75,2300,1.0,0,1960,340
618500.0,3.0,2.0,1800,1.0,0,1080,720
487585.0,4.0,1.75,2010,1.0,0,1470,540
509900.0,3.0,2.5,1790,2.0,0,1790,0
631625.0,4.0,2.5,2440,2.0,0,2440,0
555000.0,3.0,2.5,1940,2.0,0,1940,0
340000.0,2.0,1.5,1160,2.0,0,1160,0
830000.0,4.0,2.5,3400,2.0,0,3400,0
366750.0,3.0,3.0,1571,3.0,0,1571,0
415000.0,3.0,2.25,1620,2.5,0,1540,80
416286.0,3.0,2.5,1408,3.0,0,1408,0
478000.0,3.0,2.5,3040,2.0,0,3040,0
419190.0,2.0,2.5,1590,2.0,0,1590,0
712198.0,4.0,2.5,2450,2.0,0,2450,0
397000.0,4.0,2.0,1440,1.0,0,1200,240
450000.0,2.0,2.0,1100,1.5,0,1100,0
353000.0,3.0,1.0,1350,1.0,0,860,490
609000.0,4.0,2.5,2150,2.0,0,2150,0
234000.0,3.0,1.75,1490,1.0,0,1010,480
561000.0,3.0,2.0,2000,2.0,0,2000,0
469000.0,2.0,1.0,1030,1.0,0,1030,0
329350.0,2.0,1.0,720,1.0,0,720,0
488000.0,5.0,2.0,2020,1.5,0,2020,0
279900.0,3.0,1.75,1580,1.0,1,1100,480
606000.0,4.0,2.5,2110,2.0,0,2110,0
312000.0,4.0,2.0,1300,1.0,0,1300,0
650000.0,3.0,1.5,1630,1.0,1,1160,470
1135000.0,4.0,2.75,3370,1.0,3,1970,1400
325000.0,4.0,2.5,1890,1.0,0,980,910
425000.0,4.0,2.0,1520,1.0,0,1520,0
219000.0,2.0,1.0,900,1.0,0,900,0
250000.0,3.0,1.0,1050,1.0,0,1050,0
390000.0,3.0,1.75,1260,1.0,0,1260,0
736000.0,4.0,2.5,2290,2.0,0,2290,0
407000.0,4.0,2.25,2810,1.0,1,1710,1100
272000.0,3.0,2.5,1650,2.0,0,1650,0
362000.0,3.0,2.25,1640,1.0,0,1140,500
535000.0,3.0,2.5,1850,2.0,0,1850,0
284000.0,4.0,2.5,2000,2.0,0,2000,0
367500.0,3.0,1.5,1410,1.0,0,1410,0
379900.0,4.0,1.75,1500,1.0,0,1000,500
175000.0,3.0,1.0,1010,1.0,0,1010,0
460000.0,2.0,2.25,1230,2.0,0,1020,210
345000.0,4.0,2.5,2331,2.0,0,2331,0
455000.0,5.0,2.5,2240,1.0,0,1340,900
610000.0,4.0,3.0,2450,1.0,0,1580,870
563000.0,4.0,3.0,3100,2.0,0,2400,700
612500.0,4.0,2.0,2060,1.0,0,1030,1030
218000.0,3.0,1.75,1850,1.0,0,1320,530
404000.0,4.0,1.75,1840,1.0,0,960,880
860000.0,4.0,2.0,3740,2.0,0,3740,0
136500.0,3.0,1.5,1420,1.0,0,1420,0
313950.0,3.0,1.0,1510,1.0,0,860,650
575000.0,3.0,1.75,2130,1.0,2,1170,960
1225000.0,4.0,2.25,3490,2.0,0,2280,1210
280000.0,3.0,1.75,1630,1.0,0,1630,0
515000.0,3.0,2.5,1790,2.0,0,1790,0
513000.0,4.0,2.5,2000,2.0,0,2000,0
599000.0,4.0,2.25,2260,2.0,0,1400,860
685000.0,4.0,2.5,3030,2.0,0,3030,0
365000.0,3.0,1.5,1310,1.0,0,1310,0
762300.0,4.0,2.5,3880,2.0,0,3880,0
562000.0,5.0,2.25,3040,2.0,0,3040,0
530000.0,5.0,2.5,2910,1.0,0,1690,1220
525000.0,3.0,2.5,2970,1.0,0,1770,1200
484000.0,2.0,1.75,1660,1.0,0,1160,500
725126.0,4.0,2.5,3200,2.0,0,3200,0
360000.0,4.0,2.0,2680,1.0,0,2680,0
387000.0,3.0,1.0,1230,1.0,0,1230,0
483500.0,4.0,2.5,2740,2.0,0,2740,0
655500.0,4.0,3.5,3380,2.0,0,3380,0
345000.0,3.0,1.0,1110,1.0,0,1110,0
533000.0,5.0,2.75,1800,1.5,0,1400,400
385000.0,3.0,1.75,1900,1.0,0,1280,620
675000.0,2.0,1.0,930,1.0,2,930,0
197000.0,3.0,1.75,1690,1.0,0,1060,630
485000.0,3.0,2.0,1420,1.5,0,1420,0
295000.0,3.0,2.25,1980,1.0,0,1560,420
499000.0,2.0,1.75,1170,1.0,0,740,430
1050000.0,3.0,2.5,2200,2.0,0,1610,590
191000.0,3.0,1.5,800,1.0,0,800,0
500000.0,3.0,2.5,1480,3.0,0,1480,0
979000.0,3.0,2.5,2690,3.0,0,2690,0
580000.0,4.0,3.25,3569,2.0,0,3569,0
369950.0,3.0,2.0,1270,3.0,0,1270,0
776000.0,4.0,2.5,3040,2.0,0,3040,0
519950.0,3.0,2.25,1170,3.0,0,1170,0
255000.0,5.0,2.25,2060,1.0,0,1030,1030
495000.0,3.0,1.0,990,1.0,0,990,0
510000.0,4.0,2.5,2430,2.0,0,2430,0
253000.0,3.0,1.75,1250,1.0,0,1250,0
503000.0,3.0,2.75,1540,1.0,0,1210,330
275000.0,3.0,2.5,1600,2.0,0,1600,0
249000.0,3.0,1.0,1110,1.0,0,1110,0
310000.0,3.0,1.75,1840,1.0,0,1220,620
750000.0,3.0,2.75,2520,1.0,0,1360,1160
758000.0,4.0,2.75,2410,1.0,0,1780,630
248500.0,4.0,1.75,1720,1.0,0,1720,0
310000.0,3.0,1.75,2070,1.0,0,1420,650
460000.0,3.0,2.0,1760,2.0,0,1760,0
675000.0,3.0,1.75,1680,1.0,0,1680,0
526000.0,2.0,2.0,1550,1.5,0,1550,0
415000.0,4.0,3.0,1830,2.0,0,1830,0
246000.0,3.0,1.0,1400,1.0,0,1400,0
314500.0,3.0,1.75,1870,1.0,0,1870,0
420000.0,2.0,1.5,1040,1.5,0,1040,0
350000.0,3.0,1.0,1010,1.0,0,1010,0
515000.0,3.0,1.75,1580,1.0,1,1210,370
749950.0,4.0,2.75,2600,2.0,0,1960,640
230000.0,3.0,2.5,1920,2.0,0,1920,0
568000.0,3.0,2.0,2350,1.5,0,1780,570
250000.0,1.0,1.0,1100,1.0,0,820,280
581000.0,4.0,2.0,2510,1.0,0,1280,1230
500000.0,2.0,1.0,1010,1.5,0,1010,0
475000.0,2.0,1.0,820,1.0,0,820,0
352000.0,5.0,2.5,2420,1.0,2,1620,800
420000.0,3.0,2.25,1770,2.0,0,1770,0
428000.0,2.0,2.0,1350,1.0,0,1350,0
599000.0,3.0,1.75,1960,1.0,0,1090,870
492000.0,4.0,2.5,3305,1.5,0,2245,1060
630000.0,2.0,2.25,2550,1.0,0,1720,830
1110000.0,4.0,1.5,2310,1.0,0,1890,420
575000.0,4.0,2.0,1650,1.0,0,1650,0
705000.0,4.0,2.5,2650,1.5,0,1520,1130
940000.0,4.0,2.25,1890,1.0,1,1470,420
313000.0,3.0,1.75,2190,1.0,0,2190,0
618080.0,3.0,2.5,2030,2.0,0,2030,0
640000.0,3.0,3.0,2270,2.0,0,2130,140
485000.0,3.0,2.0,1610,1.0,0,1010,600
300000.0,2.0,1.0,760,1.0,0,760,0
379500.0,2.0,1.0,1640,1.0,0,840,800
339950.0,3.0,2.25,1630,2.0,0,1630,0
1340000.0,3.0,3.0,2960,2.0,2,2440,520
500000.0,3.0,2.5,1940,1.0,0,1940,0
239900.0,3.0,2.0,1410,1.0,0,1410,0
314950.0,3.0,1.0,1040,1.0,0,1040,0
361280.0,2.0,1.0,820,1.0,0,820,0
100000.0,2.0,1.0,910,1.0,0,910,0
480500.0,4.0,2.5,2180,1.0,0,2180,0
280000.0,3.0,2.5,1600,2.0,0,1600,0
440000.0,3.0,1.75,1500,1.0,0,1060,440
530000.0,3.0,1.0,1340,1.0,0,1080,260
560000.0,3.0,2.0,1860,1.0,0,1860,0
775000.0,3.0,2.0,2540,1.5,3,1600,940
160000.0,2.0,1.0,1040,1.0,0,1040,0
209950.0,3.0,1.5,1380,1.0,0,1380,0
226500.0,3.0,1.75,1640,1.0,0,1130,510
380000.0,5.0,1.75,3000,1.0,0,1500,1500
409500.0,4.0,2.75,2140,1.0,0,1320,820
690000.0,3.0,2.0,1760,1.0,0,980,780
405000.0,3.0,2.25,1660,1.0,0,1660,0
375000.0,3.0,2.5,1830,2.0,0,1830,0
794154.0,4.0,2.0,2210,1.0,1,1210,1000
185000.0,4.0,1.0,1490,1.0,0,1490,0
245000.0,3.0,1.5,1260,2.0,0,1040,220
1040000.0,4.0,3.5,3900,2.0,0,3900,0
425000.0,2.0,2.5,1150,3.0,0,1150,0
495000.0,4.0,2.75,2656,2.0,0,2656,0
365000.0,5.0,2.75,2410,1.0,0,1410,1000
417250.0,3.0,2.25,1606,3.0,0,1606,0
339950.0,2.0,1.0,820,3.0,0,820,0
615000.0,2.0,1.0,1540,1.0,0,820,720
403000.0,3.0,2.75,2090,2.0,0,2090,0
980000.0,5.0,2.5,3160,1.0,0,1780,1380
258000.0,4.0,1.75,1730,1.0,0,1230,500
533000.0,3.0,1.0,1670,1.0,0,1170,500
537500.0,4.0,2.5,2550,2.0,0,2550,0
830000.0,5.0,3.0,3040,1.0,0,1970,1070
712000.0,3.0,1.0,1250,1.5,0,1150,100
262000.0,4.0,2.5,2020,2.0,0,2020,0
753888.0,4.0,2.5,2660,2.0,2,2660,0
134000.0,2.0,1.5,980,2.0,0,980,0
402000.0,3.0,2.5,1960,1.0,0,1290,670
205000.0,2.0,1.0,720,1.0,0,720,0
553650.0,2.0,2.5,1360,2.0,0,1050,310
559950.0,2.0,2.0,1870,1.0,0,1870,0
260000.0,4.0,1.5,2130,1.0,0,1100,1030
270000.0,4.0,2.5,1810,2.0,0,1810,0
719000.0,3.0,2.5,1690,1.5,1,1690,0
266000.0,3.0,2.5,1940,1.0,0,1460,480
325900.0,4.0,2.5,2320,2.0,0,2320,0
647500.0,4.0,1.75,2060,1.0,0,1160,900
1039000.0,4.0,1.0,3410,2.0,0,2190,1220
569000.0,4.0,2.25,2250,2.0,0,2250,0
246000.0,3.0,1.75,1390,1.0,0,1390,0
515000.0,2.0,1.0,1060,1.0,0,1060,0
207000.0,3.0,1.0,1490,1.0,0,1490,0
780000.0,4.0,1.75,2480,1.0,0,1390,1090
489990.0,5.0,2.25,2440,1.5,0,2440,0
295000.0,3.0,2.5,1920,2.0,0,1920,0
385000.0,3.0,1.75,1890,1.0,0,1230,660
350000.0,4.0,1.75,2250,1.0,0,2150,100
235000.0,2.0,1.0,1270,1.0,0,650,620
358000.0,2.0,1.5,960,2.0,0,960,0
716500.0,4.0,2.5,3290,2.0,0,3290,0
228000.0,4.0,1.75,2000,1.0,0,1100,900
405000.0,2.0,1.0,1020,1.0,0,1020,0
538000.0,4.0,1.75,1840,1.0,0,1220,620
530000.0,3.0,1.75,1980,1.0,0,1980,0
636000.0,2.0,1.75,1230,1.5,0,1230,0
868500.0,3.0,2.5,2920,3.0,0,2920,0
530000.0,4.0,2.75,2280,1.5,0,1540,740
450000.0,3.0,2.0,1510,1.0,0,1510,0
230000.0,3.0,1.75,950,1.0,0,790,160
229000.0,3.0,2.5,1190,2.0,0,1190,0
437000.0,3.0,1.75,1310,1.0,0,1310,0
1307000.0,5.0,3.25,2800,1.5,0,1910,890
595000.0,3.0,2.5,1750,2.0,0,1750,0
660000.0,3.0,1.75,1320,1.5,0,1320,0
347500.0,4.0,2.5,2460,2.0,0,2460,0
297950.0,3.0,2.0,1240,1.0,0,1240,0
245000.0,3.0,1.5,1260,1.0,0,1260,0
1250000.0,4.0,3.25,3820,2.0,1,3310,510
413450.0,3.0,2.5,1540,3.0,0,1470,70
424500.0,3.0,1.75,1460,1.0,0,1460,0
230000.0,3.0,1.0,1390,1.0,0,1390,0
930000.0,3.0,3.25,2640,2.0,0,1840,800
349000.0,3.0,1.75,1590,1.0,0,1590,0
835000.0,4.0,2.0,1910,1.5,0,1910,0
988500.0,3.0,2.75,2015,2.0,4,2015,0
500000.0,3.0,1.75,1410,3.0,0,1410,0
499000.0,2.0,1.5,1110,2.0,0,930,180
321950.0,2.0,1.25,860,2.0,0,860,0
494000.0,3.0,2.5,2310,2.0,0,2310,0
441750.0,2.0,1.5,1020,3.0,0,1020,0
438000.0,2.0,1.0,980,2.0,0,980,0
352000.0,3.0,2.25,1640,1.0,0,1640,0
839900.0,4.0,3.5,3810,1.0,1,2560,1250
765000.0,4.0,2.75,2790,2.0,0,2790,0
460000.0,4.0,1.75,1750,1.5,0,1050,700
224500.0,4.0,1.0,1430,1.5,0,1430,0
254000.0,3.0,2.5,1850,2.0,0,1850,0
255000.0,2.0,1.0,960,1.0,0,960,0
610000.0,3.0,3.0,2480,1.0,0,1620,860
920000.0,4.0,3.0,3750,2.0,0,3750,0
402500.0,4.0,2.5,2600,2.0,0,2600,0
280950.0,3.0,1.75,1390,1.0,3,840,550
604000.0,4.0,2.5,2260,2.0,0,2260,0
565000.0,4.0,2.25,2470,2.0,0,2470,0
445000.0,4.0,2.0,1650,1.0,0,1000,650
195000.0,2.0,1.0,720,1.0,0,720,0
275000.0,3.0,1.5,1390,1.0,0,1390,0
387000.0,3.0,2.25,1445,2.0,0,1300,145
490000.0,2.0,1.0,1840,1.5,0,1130,710
505000.0,3.0,2.5,2100,2.0,2,2100,0
303500.0,3.0,1.5,1060,1.0,0,1060,0
270000.0,3.0,1.5,1500,1.0,0,1500,0
323000.0,4.0,2.75,1970,1.0,0,1170,800
382000.0,3.0,3.25,1410,3.0,0,1410,0
280000.0,4.0,2.0,2190,1.0,0,1180,1010
260000.0,3.0,2.0,1920,1.0,0,1510,410
201500.0,3.0,1.0,1160,1.0,0,1160,0
536500.0,4.0,1.75,2000,1.5,0,1450,550
248000.0,4.0,3.0,2163,2.0,0,2163,0
580000.0,4.0,2.5,2840,2.0,0,2840,0
463000.0,2.0,1.0,1150,1.0,0,1150,0
742500.0,4.0,2.75,3100,2.0,0,2000,1100
260000.0,3.0,2.5,1420,1.0,0,1020,400
590000.0,4.0,2.25,2430,1.0,0,2430,0
312000.0,4.0,2.25,1930,1.0,0,1430,500
566000.0,3.0,2.25,1660,1.0,0,1370,290
511555.0,3.0,2.0,1400,1.0,0,1400,0
583000.0,4.0,2.5,2660,2.0,0,2660,0
290000.0,4.0,2.5,2000,1.0,0,1200,800
311100.0,4.0,2.25,2130,1.0,0,1380,750
325000.0,3.0,2.25,1352,3.0,0,1352,0
491300.0,3.0,1.75,1750,1.0,1,1300,450
315000.0,5.0,1.75,2320,1.0,0,1160,1160
330000.0,4.0,2.5,1940,2.0,0,1940,0
481450.0,3.0,2.0,1410,1.0,0,1410,0
234950.0,3.0,1.0,1360,1.0,0,1360,0
251000.0,3.0,1.75,1220,1.0,0,1220,0
782000.0,4.0,2.5,2830,2.0,0,1980,850
833000.0,4.0,2.75,3780,2.0,0,3780,0
542500.0,4.0,2.5,2330,2.0,0,2330,0
252500.0,3.0,1.0,1030,1.0,0,880,150
465000.0,4.0,2.5,1930,1.0,0,1930,0
225000.0,3.0,2.5,2000,2.0,0,2000,0
270000.0,3.0,2.0,1690,1.0,0,1690,0
536000.0,3.0,1.75,1300,1.5,0,1300,0
585000.0,4.0,3.25,2400,2.0,0,2400,0
445000.0,2.0,2.0,1150,1.0,0,860,290
320000.0,4.0,2.25,2310,2.0,0,2310,0
769900.0,4.0,3.5,2730,2.0,0,2400,330
557000.0,4.0,2.5,2840,2.0,0,2840,0
212000.0,2.0,1.5,1020,2.0,0,1020,0
376000.0,3.0,2.0,1340,3.0,0,1340,0
324000.0,3.0,2.25,998,2.0,0,798,200
549900.0,5.0,2.75,3060,1.0,0,1600,1460
320000.0,3.0,2.5,2130,2.0,0,2130,0
875000.0,4.0,2.0,2520,1.0,0,1400,1120
265000.0,4.0,1.0,1940,1.0,0,1080,860
394950.0,3.0,2.5,1350,3.0,0,1270,80
842500.0,4.0,2.5,2160,2.5,0,2160,0
368000.0,3.0,2.5,1370,2.0,0,1010,360
885000.0,4.0,2.5,2830,2.0,0,2830,0
453246.0,3.0,2.5,2010,2.0,0,1390,620
927000.0,4.0,2.75,3300,2.0,0,3300,0
490000.0,2.0,2.5,1230,2.0,0,870,360
341000.0,3.0,1.5,1720,1.5,0,1720,0
235000.0,1.0,1.0,810,1.0,0,810,0
1200000.0,3.0,1.75,1560,1.5,4,1560,0
255000.0,2.0,1.0,1220,1.0,0,770,450
876650.0,3.0,3.25,2170,1.5,0,1650,520
350000.0,2.0,1.0,910,1.5,0,910,0
750000.0,4.0,2.5,2980,2.0,0,2890,90
582000.0,4.0,1.75,2120,1.0,1,1190,930
1315000.0,4.0,3.5,3460,2.0,0,2560,900
372500.0,5.0,3.0,2480,1.0,0,1300,1180
410000.0,3.0,2.25,2200,2.0,0,2200,0
360000.0,4.0,2.0,1730,1.0,0,1010,720
1015000.0,3.0,2.5,2920,1.0,4,1800,1120
225000.0,3.0,1.0,990,1.0,0,990,0
647000.0,4.0,2.5,3040,2.0,0,3040,0
185000.0,3.0,1.5,1370,1.0,0,1370,0
335000.0,3.0,2.5,1940,2.0,0,1940,0
210000.0,3.0,2.5,1040,2.0,0,720,320
522000.0,4.0,2.25,1800,1.0,0,1360,440
770000.0,3.0,1.75,1720,1.0,0,1720,0
499950.0,3.0,1.0,980,1.0,0,760,220
751000.0,4.0,2.5,3110,2.0,0,3110,0
330000.0,5.0,3.0,2100,1.0,0,1250,850
465000.0,3.0,1.5,2020,1.0,0,1190,830
850000.0,4.0,1.75,2350,1.0,0,2350,0
947500.0,4.0,2.25,3290,1.5,0,3290,0
302000.0,5.0,2.25,2180,2.0,0,2180,0
500000.0,2.0,2.25,1290,3.0,0,1290,0
201000.0,3.0,1.0,1460,1.0,0,1460,0
265000.0,2.0,1.0,1290,2.0,0,1290,0
870300.0,4.0,2.5,2350,1.5,0,1690,660
339000.0,3.0,1.0,1080,1.0,0,1080,0
690000.0,4.0,2.5,2670,2.0,0,2670,0
788000.0,4.0,3.25,3680,2.0,0,2840,840
315275.0,3.0,1.75,1440,1.0,0,960,480
505000.0,4.0,1.75,1940,1.0,0,1030,910
368000.0,3.0,1.0,1280,1.0,0,1280,0
947500.0,3.0,2.75,2980,1.5,2,2180,800
156000.0,3.0,1.0,970,1.0,0,970,0
610000.0,4.0,3.0,2110,1.5,2,1640,470
420000.0,2.0,2.5,1480,3.0,0,1480,0
192000.0,2.0,1.0,700,1.0,0,700,0
910000.0,3.0,2.0,2700,1.0,0,1350,1350
1300000.0,4.0,3.25,2330,2.0,3,2330,0
840000.0,4.0,2.75,2600,1.5,0,1620,980
300000.0,2.0,1.75,1360,1.0,0,860,500
505000.0,4.0,2.5,2780,1.0,0,1590,1190
746000.0,3.0,2.5,2620,2.0,0,2620,0
211000.0,3.0,1.5,1350,1.0,0,1350,0
675000.0,4.0,3.0,2400,1.0,0,1200,1200
734200.0,4.0,2.5,2760,1.5,0,1680,1080
1225000.0,4.0,2.25,3070,1.0,3,1870,1200
615000.0,2.0,1.75,2040,1.5,3,2040,0
630000.0,4.0,2.0,1770,2.0,0,1770,0
1264000.0,4.0,3.75,3490,2.0,0,3490,0
301500.0,2.0,1.5,830,2.0,0,830,0
369000.0,2.0,2.5,980,2.0,0,670,310
635000.0,3.0,2.5,1570,3.0,0,1570,0
1033888.0,4.0,3.25,3270,2.0,0,3110,160
383000.0,4.0,2.5,2160,2.0,0,2160,0
1050000.0,4.0,3.75,3280,2.0,0,2320,960
455000.0,4.0,2.5,3360,2.0,0,3360,0
819900.0,5.0,2.75,3150,2.0,0,3150,0
625000.0,3.0,3.5,1810,2.0,0,1440,370
651000.0,4.0,2.5,2740,2.0,0,2740,0
757000.0,3.0,3.25,3190,2.0,0,3190,0
460000.0,3.0,2.25,2350,1.0,0,1390,960
267345.0,4.0,2.25,2510,1.0,0,1610,900
530000.0,2.0,2.0,1680,1.0,0,1680,0
449500.0,3.0,2.0,1770,1.0,0,960,810
289000.0,3.0,1.0,1090,1.0,0,1090,0
373000.0,5.0,2.5,3001,2.0,0,3001,0
525000.0,5.0,3.0,2450,2.0,0,2450,0
550000.0,4.0,2.0,2250,1.0,0,1200,1050
523000.0,3.0,1.5,1240,1.0,0,1240,0
628000.0,4.0,2.0,2260,1.0,0,1430,830
581000.0,4.0,1.75,2090,1.0,0,1070,1020
245000.0,5.0,1.75,2020,1.0,0,1220,800
415000.0,3.0,1.75,1960,1.0,0,980,980
225000.0,3.0,1.5,1250,1.0,0,1250,0
287000.0,3.0,2.25,1490,1.0,0,1170,320
239950.0,3.0,1.0,1900,1.5,0,1900,0
591000.0,3.0,1.75,1680,1.0,0,870,810
700000.0,3.0,2.5,2030,2.0,0,2030,0
475000.0,4.0,2.5,3740,1.0,0,2260,1480
575000.0,3.0,1.75,1580,1.0,0,1180,400
771000.0,3.0,2.25,1780,1.5,0,1390,390
155000.0,2.0,1.0,910,1.0,0,910,0
645000.0,3.0,2.5,1740,2.0,0,1740,0
350000.0,3.0,2.5,2010,2.0,0,2010,0
591000.0,4.0,2.25,2710,2.0,0,2710,0
717000.0,3.0,1.5,1310,1.0,0,1090,220
225000.0,4.0,1.5,1950,1.5,0,1950,0
225000.0,3.0,1.0,1040,1.0,0,1040,0
345000.0,3.0,1.75,1090,1.0,0,1090,0
230000.0,2.0,0.75,650,1.0,0,650,0
385000.0,3.0,2.0,1480,1.0,2,740,740
90000.0,2.0,1.0,790,1.0,0,790,0
860000.0,4.0,2.5,3560,1.0,2,2290,1270
675000.0,4.0,2.5,3000,2.0,0,3000,0
975000.0,4.0,2.5,3490,2.0,3,3490,0
780000.0,3.0,1.75,2340,1.0,0,2340,0
370000.0,3.0,1.75,1650,1.0,0,1060,590
665000.0,3.0,2.0,1940,1.5,0,1150,790
620000.0,3.0,1.0,1710,1.5,0,1710,0
1105000.0,4.0,1.5,2740,2.0,0,1930,810
450000.0,3.0,2.75,1250,2.0,0,1040,210
450000.0,3.0,2.25,2450,1.0,0,2450,0
530000.0,3.0,1.75,1690,1.0,0,1690,0
635000.0,4.0,1.75,1950,1.0,0,1370,580
580000.0,5.0,2.0,2290,1.0,0,1190,1100
285000.0,3.0,1.0,1090,1.0,0,1090,0
375000.0,3.0,1.0,1190,1.0,0,1190,0
560000.0,3.0,1.0,1440,2.0,0,1440,0
405000.0,4.0,1.75,2180,1.0,0,1090,1090
413000.0,4.0,1.0,1410,1.0,0,810,600
287600.0,3.0,2.5,1950,2.0,0,1950,0
225000.0,3.0,1.0,1660,1.0,0,1100,560
319000.0,3.0,1.0,1390,1.0,0,1390,0
322500.0,3.0,2.0,1350,1.0,0,1350,0
570000.0,3.0,2.0,1530,1.0,0,1530,0
465000.0,3.0,1.5,1270,1.0,0,1270,0
435000.0,4.0,2.25,2140,2.0,0,2140,0
502000.0,4.0,2.5,2040,2.0,0,2040,0
525000.0,3.0,3.5,2876,2.0,0,2360,516
525000.0,3.0,2.5,1580,2.0,0,1010,570
660000.0,4.0,3.5,3400,2.0,0,3400,0
870000.0,4.0,2.5,3520,2.5,0,2650,870
650000.0,4.0,2.5,2210,2.0,0,2210,0
505000.0,4.0,2.5,2790,2.0,0,2790,0
330000.0,3.0,2.5,1450,1.0,0,840,610
385000.0,4.0,1.75,1620,1.0,0,860,760
306000.0,3.0,1.5,1220,3.0,0,1220,0
546000.0,3.0,1.75,2000,1.0,0,1110,890
925000.0,4.0,2.5,2190,2.5,0,2190,0
542000.0,4.0,1.75,1900,1.0,0,950,950
800000.0,3.0,1.0,1700,1.5,0,1700,0
620000.0,5.0,2.5,2540,2.0,0,1760,780
175000.0,2.0,1.0,1170,1.0,2,1170,0
345000.0,3.0,2.25,2120,2.0,0,2120,0
510000.0,3.0,1.75,2170,1.0,0,1450,720
530000.0,4.0,2.75,2450,1.0,0,2450,0
155000.0,2.0,1.0,700,1.0,0,700,0
266000.0,3.0,2.5,1780,1.0,0,1400,380
257200.0,3.0,2.0,1850,1.0,0,1150,700
265000.0,3.0,2.0,1570,1.0,0,1570,0
372220.0,3.0,1.0,1290,1.0,0,980,310
337500.0,5.0,2.0,1700,1.0,0,1000,700
582500.0,2.0,1.5,1159,1.0,0,1159,0
489200.0,3.0,2.75,1850,1.5,0,1850,0
405100.0,2.0,1.0,840,1.0,0,840,0
372977.0,3.0,2.5,1690,2.0,0,1150,540
310000.0,3.0,1.0,1050,1.0,0,1050,0
538000.0,3.0,1.75,1400,1.5,0,1100,300
317000.0,3.0,2.5,1840,2.0,0,1840,0
702500.0,3.0,1.5,2360,2.0,0,1930,430
565000.0,4.0,2.5,2240,2.0,0,2240,0
723000.0,4.0,2.5,2700,2.0,0,2700,0
766950.0,3.0,2.5,3030,1.5,0,3030,0
682000.0,3.0,1.75,1830,1.5,2,1830,0
325000.0,3.0,2.5,2220,2.0,0,2220,0
543000.0,3.0,2.5,2090,1.0,0,1360,730
525000.0,3.0,1.75,1600,1.5,0,1600,0
364000.0,4.0,1.75,2010,1.0,0,1340,670
394475.0,2.0,1.0,830,1.0,0,830,0
316000.0,4.0,2.5,2010,2.0,0,2010,0
339950.0,3.0,1.0,1050,1.5,0,1050,0
486000.0,4.0,2.5,2150,1.0,0,1420,730
160000.0,3.0,1.0,860,1.0,0,860,0
930000.0,3.0,2.5,3100,1.0,0,3100,0
139000.0,3.0,1.0,1100,1.0,0,1100,0
562000.0,3.0,1.5,1830,1.0,0,1830,0
299000.0,2.0,1.75,1250,1.0,0,1250,0
511000.0,3.0,2.5,1820,2.0,0,1820,0
499000.0,3.0,2.0,2090,1.5,0,2090,0
356000.0,3.0,3.5,2100,2.0,0,2100,0
470000.0,4.0,2.5,2310,2.0,0,2310,0
715000.0,4.0,2.25,2060,1.0,0,1360,700
458000.0,3.0,1.0,1660,1.0,0,1060,600
305495.0,3.0,1.75,2110,2.0,0,2110,0
340000.0,3.0,2.25,1970,2.0,0,1970,0
633100.0,4.0,2.5,2470,2.0,0,2470,0
310000.0,3.0,1.0,1480,1.0,0,1480,0
349950.0,5.0,3.0,2257,1.0,0,1363,894
267800.0,2.0,1.0,700,1.0,0,700,0
234000.0,4.0,2.0,1630,1.0,0,1050,580
740000.0,4.0,2.5,3430,2.0,0,3430,0
607500.0,5.0,1.75,2220,1.5,0,1420,800
223000.0,3.0,1.75,1340,1.0,0,1340,0
400000.0,2.0,1.0,980,1.0,0,860,120
802000.0,3.0,2.5,2580,2.0,0,2580,0
253000.0,4.0,2.5,2230,2.0,0,2230,0
1058000.0,4.0,2.0,2290,1.0,0,2290,0
300000.0,3.0,1.0,1260,1.0,0,1260,0
625000.0,4.0,2.75,1680,1.0,0,1680,0
707000.0,4.0,3.25,3200,2.0,0,3200,0
950000.0,4.0,2.5,3320,2.0,0,3320,0
420000.0,4.0,2.5,3040,2.0,0,3040,0
498000.0,4.0,2.75,2270,1.0,0,1290,980
450000.0,3.0,2.5,2910,2.0,0,2910,0
955000.0,5.0,2.25,2510,2.0,0,2510,0
215000.0,2.0,1.0,1240,1.0,0,1240,0
437000.0,3.0,2.75,2580,2.0,0,2580,0
773000.0,3.0,2.75,2470,2.0,0,2470,0
256883.0,3.0,2.5,1690,2.0,0,1690,0
592500.0,4.0,2.5,2240,1.0,0,2240,0
252350.0,3.0,2.0,1650,1.0,0,1160,490
370000.0,4.0,2.5,2710,2.0,0,2710,0
465750.0,3.0,1.5,1260,1.0,0,1260,0
185000.0,3.0,1.0,1150,1.0,0,1150,0
582800.0,4.0,2.75,2550,1.0,0,1440,1110
245000.0,3.0,1.75,1490,1.0,0,1490,0
302000.0,4.0,1.75,2020,1.0,0,1010,1010
451555.0,2.0,1.0,1320,1.0,1,1320,0
250000.0,3.0,1.0,1230,1.0,0,1230,0
255000.0,4.0,2.5,2070,2.0,0,2070,0
840000.0,4.0,1.75,2930,1.0,3,1670,1260
190000.0,3.0,1.0,1090,1.0,0,1090,0
349950.0,3.0,1.0,1400,1.0,0,1400,0
613000.0,4.0,2.0,1550,1.5,0,1550,0
300000.0,3.0,1.0,1220,1.0,0,1220,0
455000.0,3.0,2.5,1870,1.0,0,1470,400
335000.0,3.0,2.25,2150,2.0,0,2150,0
197500.0,3.0,1.0,980,1.5,0,980,0
412500.0,3.0,1.5,1490,1.0,0,1490,0
395300.0,3.0,1.5,1120,1.0,0,1120,0
342400.0,3.0,2.25,1180,2.0,0,1180,0
749400.0,4.0,2.5,3240,2.0,0,3240,0
316500.0,4.0,2.5,2150,2.0,0,2150,0
390000.0,3.0,2.5,2240,2.0,0,2240,0
225000.0,3.0,2.0,1400,1.0,0,1150,250
550000.0,3.0,2.25,1980,1.0,0,1980,0
280000.0,3.0,1.0,1330,1.5,0,1330,0
1255000.0,4.0,2.5,3200,2.0,0,3200,0
575000.0,2.0,1.0,1490,1.0,0,1090,400
585000.0,5.0,1.75,2000,2.0,0,2000,0
620000.0,4.0,2.5,2680,2.0,0,2680,0
204700.0,4.0,2.0,1670,1.0,0,1670,0
695000.0,4.0,3.0,3150,2.0,0,3150,0
689900.0,4.0,3.25,2740,2.0,0,2060,680
375000.0,4.0,1.75,1890,1.0,0,1250,640
215000.0,3.0,1.0,1160,1.0,0,1160,0
790000.0,3.0,1.75,1790,1.0,2,1350,440
263000.0,3.0,2.25,1590,2.0,0,1590,0
400000.0,3.0,1.0,1630,1.0,0,1630,0
525000.0,3.0,2.5,2700,2.0,0,2700,0
349950.0,3.0,2.5,1700,2.0,0,1700,0
744000.0,4.0,3.0,1980,2.5,0,1980,0
312500.0,2.0,1.0,880,1.0,0,880,0
240000.0,3.0,2.0,1400,1.0,0,700,700
495000.0,4.0,2.0,2050,1.5,0,1210,840
580050.0,3.0,2.5,2360,2.0,3,2360,0
640000.0,4.0,2.0,2560,1.0,0,1890,670
417000.0,3.0,1.5,1340,1.0,0,1340,0
174950.0,3.0,1.0,1060,1.0,0,1060,0
295000.0,3.0,1.5,850,1.0,0,850,0
423000.0,4.0,1.75,1880,1.0,0,1010,870
839000.0,3.0,1.0,1230,1.0,0,1230,0
343000.0,4.0,1.75,2290,1.0,0,1340,950
467000.0,3.0,1.0,1660,1.0,0,1000,660
512500.0,3.0,2.5,1840,2.0,0,1840,0
575000.0,4.0,2.5,3020,1.0,0,1600,1420
465000.0,3.0,1.75,1410,1.0,0,1410,0
270000.0,3.0,1.0,1010,1.0,0,1010,0
340000.0,3.0,1.75,1960,1.0,0,980,980
765000.0,5.0,3.75,3580,2.0,0,3190,390
497000.0,4.0,2.5,2240,2.0,0,2240,0
803100.0,4.0,2.5,3310,2.0,0,3310,0
344000.0,3.0,2.5,1232,3.0,0,1232,0
828950.0,4.0,3.5,3930,2.0,1,2820,1110
386380.0,3.0,2.5,1720,2.0,0,1720,0
312000.0,3.0,2.25,1490,2.0,0,1220,270
914500.0,4.0,2.5,3950,3.0,0,3950,0
819995.0,5.0,2.75,3030,2.0,0,3030,0
252700.0,2.0,1.5,1070,1.0,0,1070,0
437500.0,3.0,2.5,2320,2.0,2,2320,0
350000.0,1.0,1.0,700,1.0,0,700,0
619000.0,3.0,2.5,2720,2.0,0,2720,0
408200.0,3.0,2.5,1800,2.0,0,1800,0
451000.0,3.0,1.75,1560,1.5,2,1000,560
317000.0,3.0,2.0,1760,1.0,0,1060,700
799000.0,4.0,3.25,3120,2.0,0,2370,750
720000.0,2.0,1.0,2020,1.0,3,1700,320
490000.0,3.0,2.0,1450,1.5,0,1450,0
239900.0,4.0,2.25,1860,1.0,0,1120,740
446000.0,4.0,2.25,2270,1.0,0,1290,980
275000.0,3.0,2.5,1480,2.0,0,1480,0
239950.0,5.0,1.0,1460,2.0,0,1460,0
248000.0,4.0,3.5,1850,2.0,0,1130,720
619500.0,3.0,2.5,2170,2.0,0,2170,0
385000.0,3.0,1.75,1180,1.0,0,940,240
370000.0,4.0,1.5,1370,1.0,0,900,470
425000.0,3.0,2.5,2670,1.0,0,2670,0
342000.0,3.0,1.0,1260,1.0,0,720,540
345000.0,4.0,1.0,1980,1.5,0,1980,0
724800.0,3.0,2.0,2050,1.0,0,1180,870
725000.0,5.0,2.75,2830,2.0,0,2830,0
605000.0,2.0,1.0,910,1.0,0,910,0
350000.0,4.0,2.5,2440,2.0,0,2440,0
785000.0,3.0,2.0,2180,1.0,0,1100,1080
250000.0,3.0,2.0,1900,1.0,0,950,950
565000.0,3.0,2.25,1520,3.0,0,1520,0
875000.0,3.0,2.0,2220,1.0,2,1220,1000
862500.0,4.0,2.75,3280,2.0,0,3280,0
282613.0,2.0,1.0,830,1.0,0,830,0
174500.0,2.0,1.0,1010,1.0,0,1010,0
306500.0,3.0,2.25,2060,1.0,0,1560,500
445000.0,3.0,2.25,1990,2.0,0,1990,0
433000.0,4.0,2.5,2280,2.0,0,2280,0
306000.0,3.0,2.5,1870,2.0,0,1870,0
620000.0,3.0,2.25,1720,1.5,0,1450,270
245000.0,2.0,1.0,870,1.0,0,870,0
238000.0,3.0,2.0,1020,2.0,0,720,300
523000.0,3.0,1.5,1260,1.5,0,1260,0
522500.0,3.0,2.5,2370,2.0,0,2370,0
180000.0,3.0,1.0,1000,1.0,0,1000,0
375000.0,3.0,1.5,1100,2.0,0,940,160
249000.0,3.0,2.25,1440,1.0,0,940,500
730100.0,4.0,2.5,3120,2.0,0,3120,0
551000.0,2.0,2.0,2260,1.0,0,2260,0
375000.0,4.0,2.5,2790,2.0,0,2790,0
540000.0,1.0,1.0,1140,1.5,0,1140,0
605000.0,3.0,2.25,1290,2.0,0,1290,0
205000.0,5.0,1.75,1730,1.0,0,1050,680
645000.0,4.0,2.5,3160,2.0,0,3160,0
314000.0,4.0,2.5,2340,2.0,0,2340,0
330000.0,3.0,1.5,1170,1.0,0,1170,0
490000.0,2.0,1.0,1160,1.0,0,1160,0
445000.0,3.0,3.0,1970,1.0,0,1970,0
377500.0,3.0,2.25,1410,2.0,0,1290,120
480000.0,4.0,2.5,2430,2.0,0,2430,0
804995.0,5.0,1.5,3360,2.0,0,3360,0
341000.0,3.0,2.5,1480,2.0,0,1180,300
675000.0,5.0,2.5,3200,2.0,0,3200,0
611000.0,3.0,2.5,2134,2.5,0,2134,0
379950.0,3.0,3.25,1860,3.0,0,1860,0
500000.0,2.0,2.5,1310,2.0,0,1160,150
410000.0,3.0,2.0,1700,1.0,0,890,810
415000.0,3.0,2.5,2480,2.0,0,2480,0
297000.0,5.0,2.5,1970,2.0,0,1970,0
575550.0,4.0,2.5,2060,1.0,0,1440,620
534640.0,3.0,2.5,2130,1.0,0,1210,920
352500.0,3.0,2.25,1410,1.0,2,1170,240
488000.0,2.0,2.0,1360,1.0,0,780,580
215000.0,2.0,2.25,1610,2.0,0,1610,0
592500.0,2.0,2.0,1420,1.5,2,1420,0
290000.0,4.0,2.5,1700,2.0,0,1700,0
475000.0,2.0,1.0,1490,1.0,0,860,630
320000.0,3.0,2.5,2680,2.0,0,2680,0
1216000.0,4.0,2.5,3190,1.0,3,1680,1510
290000.0,5.0,1.5,2120,1.5,0,2120,0
487250.0,4.0,2.0,1690,1.5,0,1550,140
339000.0,4.0,2.5,1830,2.0,0,1830,0
440000.0,2.0,1.5,1010,1.5,0,1010,0
366500.0,4.0,2.75,2070,1.0,0,1120,950
462000.0,3.0,1.5,1710,1.5,0,1410,300
560000.0,4.0,1.0,1660,1.5,0,1260,400
285000.0,4.0,1.75,2080,1.0,0,1040,1040
280000.0,3.0,2.5,1270,2.0,0,1270,0
210000.0,3.0,1.0,1080,1.0,0,1080,0
690000.0,3.0,2.0,1610,1.5,0,1610,0
256500.0,2.0,1.0,1120,1.0,0,1120,0
411000.0,4.0,2.75,2500,2.0,0,2500,0
215000.0,3.0,1.0,970,1.0,0,970,0
762000.0,5.0,2.0,3370,1.5,0,2140,1230
390000.0,4.0,2.5,2490,2.0,0,2490,0
413500.0,2.0,1.0,770,1.0,0,770,0
285000.0,1.0,1.5,810,2.0,0,810,0
475000.0,4.0,2.5,3060,1.0,0,1700,1360
386591.0,3.0,2.5,1690,2.0,0,1150,540
524950.0,3.0,1.75,1890,1.0,0,1290,600
241000.0,2.0,2.0,1470,2.0,0,1470,0
461000.0,2.0,1.0,1060,1.0,0,1060,0
885000.0,4.0,2.75,2730,1.5,0,1550,1180
247000.0,3.0,2.25,1580,2.0,0,1580,0
296500.0,3.0,2.75,2170,1.0,0,1380,790
141800.0,2.0,1.0,930,1.0,0,930,0
333000.0,4.0,2.0,1580,2.0,0,1580,0
602000.0,5.0,1.75,3290,1.5,0,3290,0
565000.0,4.0,2.25,2110,2.0,0,2110,0
373000.0,3.0,2.5,1670,2.0,0,1670,0
588000.0,3.0,2.25,2030,1.0,0,1190,840
485000.0,3.0,1.0,1500,1.5,0,1370,130
482500.0,3.0,2.25,1450,2.0,0,980,470
251200.0,4.0,1.5,1310,1.0,0,1060,250
464000.0,3.0,1.75,1630,1.0,0,1630,0
755000.0,4.0,2.5,2660,2.0,0,2660,0
280000.0,3.0,2.5,1720,2.0,0,1720,0
485000.0,2.0,2.25,1260,3.0,0,1260,0
305000.0,3.0,1.75,1610,1.0,0,1610,0
110700.0,2.0,1.0,680,1.0,0,680,0
850000.0,4.0,3.5,2640,2.0,2,2640,0
350000.0,3.0,2.25,1640,2.0,0,1640,0
319950.0,4.0,1.75,2310,1.0,0,1650,660
700000.0,3.0,1.75,2010,1.0,0,1230,780
368000.0,2.0,1.5,1660,1.0,0,830,830
433500.0,3.0,2.5,2200,2.0,0,2200,0
611000.0,4.0,2.5,2460,2.0,0,2460,0
1000000.0,2.0,1.75,2430,1.0,4,2430,0
307000.0,3.0,1.0,1370,1.0,0,1370,0
442500.0,3.0,1.75,1800,1.0,0,1800,0
485000.0,3.0,1.75,2200,2.0,2,2200,0
367000.0,2.0,1.0,700,1.0,0,700,0
429000.0,3.0,2.5,1920,2.0,0,1920,0
446000.0,5.0,2.75,2190,1.0,0,1370,820
572500.0,3.0,2.25,2030,1.0,0,1500,530
477000.0,3.0,2.5,1350,3.0,0,1350,0
518000.0,3.0,2.5,1680,2.0,0,1380,300
462000.0,5.0,1.75,1250,1.0,0,1250,0
1190000.0,4.0,3.0,2240,1.5,0,1270,970
137000.0,3.0,1.0,950,1.0,0,950,0
530000.0,3.0,3.5,2320,2.0,0,2060,260
818000.0,2.0,2.5,2380,1.0,2,2380,0
640000.0,2.0,2.25,1540,3.0,0,1540,0
298450.0,5.0,3.0,2100,1.0,0,1200,900
575000.0,4.0,2.5,2500,2.0,0,2500,0
730000.0,4.0,2.5,3230,2.0,0,3230,0
551000.0,3.0,2.5,2830,2.0,0,2830,0
271310.0,2.0,1.0,870,1.5,0,870,0
675000.0,4.0,3.0,2690,1.0,0,2690,0
479000.0,3.0,2.5,1260,3.0,0,1260,0
520000.0,4.0,3.5,2680,2.0,0,2040,640
599950.0,3.0,2.5,2660,2.0,0,2660,0
483945.0,2.0,1.75,1480,1.0,0,840,640
390000.0,4.0,2.25,1770,1.0,0,1190,580
192500.0,2.0,1.0,950,1.0,0,950,0
330000.0,2.0,1.0,860,1.0,0,860,0
250000.0,4.0,2.0,1960,1.0,0,1160,800
243000.0,2.0,1.0,1770,1.5,0,960,810
575000.0,4.0,1.75,1280,1.0,0,860,420
639000.0,4.0,2.5,2150,2.0,0,2150,0
710000.0,2.0,1.0,1790,1.0,0,1040,750
675000.0,3.0,2.25,1990,2.0,0,1990,0
405000.0,5.0,2.5,2430,2.0,0,2430,0
615000.0,4.0,2.75,2820,1.0,0,1860,960
490000.0,3.0,1.0,1910,1.0,0,1010,900
467000.0,3.0,2.25,1270,2.0,0,1040,230
480000.0,4.0,2.75,2050,1.0,0,1180,870
760000.0,4.0,1.75,2450,1.0,2,1630,820
387000.0,2.0,2.25,1230,2.0,0,960,270
925000.0,4.0,2.25,2260,1.0,0,2260,0
263000.0,3.0,1.75,1570,2.0,0,1570,0
519900.0,4.0,2.0,1820,1.0,0,1820,0
570000.0,2.0,1.75,1540,1.0,0,1190,350
450000.0,3.0,1.5,2060,1.0,0,2060,0
300000.0,3.0,1.0,1090,1.0,0,1090,0
320000.0,3.0,1.75,1480,1.0,0,1480,0
387500.0,4.0,1.0,1320,1.5,0,1320,0
458000.0,1.0,2.25,2140,1.0,0,1470,670
380000.0,4.0,3.0,2800,2.0,0,2800,0
200000.0,3.0,1.0,1050,1.0,0,1050,0
385000.0,3.0,1.5,1490,1.0,0,1490,0
396675.0,2.0,1.0,1730,2.0,0,1730,0
452000.0,4.0,1.0,1210,1.5,0,1210,0
426000.0,4.0,2.5,2800,2.0,0,2800,0
792000.0,3.0,1.5,1570,2.0,0,1570,0
315000.0,3.0,2.25,1400,1.0,0,1140,260
1275000.0,4.0,2.0,2850,1.0,4,1450,1400
268500.0,2.0,1.0,790,1.0,0,790,0
440000.0,2.0,1.75,1300,2.0,0,1300,0
300000.0,3.0,1.0,2120,1.0,0,1060,1060
525000.0,3.0,1.5,1540,2.0,0,1540,0
978000.0,4.0,2.75,2620,1.5,2,1720,900
700000.0,4.0,1.0,1680,1.5,0,1680,0
315000.0,2.0,1.0,790,1.0,0,790,0
309000.0,3.0,1.0,1092,1.5,0,1092,0
219950.0,3.0,1.5,1650,1.0,0,1090,560
289000.0,3.0,2.5,2090,2.0,0,2090,0
210000.0,4.0,1.75,2180,1.0,0,1180,1000
260000.0,4.0,2.5,1990,2.0,0,1990,0
699000.0,4.0,2.5,2650,2.0,0,2650,0
299950.0,3.0,1.0,910,1.0,0,740,170
749950.0,3.0,2.5,2770,2.0,2,2770,0
1100000.0,3.0,2.0,2390,2.0,1,2390,0
384000.0,3.0,2.5,1700,2.0,0,1700,0
499950.0,5.0,3.5,3200,2.0,0,3200,0
430000.0,3.0,1.75,1200,1.0,0,1200,0
350000.0,4.0,2.25,2220,2.0,0,2220,0
620000.0,3.0,2.5,2480,2.0,0,2480,0
765000.0,4.0,2.25,2560,1.0,0,1760,800
250000.0,4.0,1.5,2500,1.0,0,1500,1000
376000.0,2.0,1.0,1150,1.0,0,1150,0
475000.0,4.0,1.75,1650,1.0,0,1150,500
120750.0,3.0,1.75,1140,1.0,0,1140,0
330000.0,3.0,1.0,1180,1.0,0,1180,0
619500.0,3.0,2.5,1700,2.0,0,1700,0
345000.0,3.0,1.5,1240,1.0,0,1240,0
598000.0,5.0,2.25,2890,2.0,0,2890,0
335000.0,3.0,1.0,1060,1.0,0,1060,0
372500.0,4.0,1.75,1590,2.0,0,1590,0
194000.0,1.0,1.0,820,1.0,0,760,60
507500.0,3.0,2.0,2020,1.0,0,1020,1000
325000.0,4.0,2.25,1870,1.0,0,1170,700
329900.0,3.0,2.5,2170,2.0,0,2170,0
329000.0,4.0,2.5,1600,1.0,0,830,770
494000.0,4.0,1.75,2090,1.5,0,1250,840
206000.0,4.0,2.0,1700,1.0,0,1700,0
423000.0,4.0,1.75,1940,1.0,0,970,970
259000.0,3.0,1.0,1320,1.0,0,1320,0
345600.0,5.0,3.5,2800,2.5,0,2800,0
395000.0,3.0,1.5,1080,1.5,0,1080,0
625000.0,4.0,2.5,3550,2.0,0,3550,0
380000.0,3.0,1.75,1690,2.0,0,1380,310
440000.0,3.0,1.5,1270,3.0,0,1270,0
415000.0,3.0,2.25,1970,2.0,0,1680,290
860000.0,4.0,2.75,3160,2.0,0,3160,0
500000.0,3.0,2.5,1210,3.0,0,1210,0
953007.0,4.0,3.5,3120,2.0,0,2480,640
515000.0,4.0,2.5,2670,2.0,0,2670,0
772000.0,3.0,2.25,1640,3.0,0,1640,0
329995.0,4.0,2.5,2303,2.0,0,2303,0
409316.0,3.0,2.5,1800,2.0,0,1800,0
305000.0,2.0,2.5,1590,2.0,0,1220,370
785000.0,4.0,3.5,3070,2.0,0,2190,880
240000.0,2.0,1.75,1330,1.0,0,1330,0
325000.0,3.0,1.0,990,1.0,0,990,0
535800.0,4.0,2.5,1900,2.0,0,1900,0
720000.0,3.0,2.5,2020,3.0,3,2020,0
374000.0,3.0,1.75,2000,1.0,0,2000,0
189650.0,2.0,1.75,1100,1.0,0,1100,0
420850.0,1.0,1.0,960,1.0,0,960,0
815000.0,4.0,2.75,3488,2.0,0,3488,0
1065000.0,2.0,1.75,1890,2.0,0,1890,0
199000.0,4.0,2.0,2030,2.0,0,2030,0
195000.0,3.0,1.75,1380,1.0,0,990,390
288400.0,3.0,2.25,1870,2.0,0,1870,0
442000.0,4.0,2.25,2080,1.0,0,1220,860
619420.0,4.0,2.75,2450,2.0,0,2450,0
635000.0,4.0,2.25,2750,1.0,0,1500,1250
210000.0,3.0,1.0,1240,1.0,0,1240,0
512500.0,3.0,2.5,1900,2.0,0,1900,0
567000.0,3.0,2.5,2540,2.0,0,2540,0
525000.0,3.0,2.75,2100,2.0,0,1510,590
475000.0,4.0,2.0,1790,1.0,2,840,950
250000.0,3.0,2.0,1170,1.0,0,1170,0
220000.0,3.0,1.0,1060,1.0,2,1060,0
230000.0,5.0,2.0,1930,1.5,0,1930,0
385500.0,3.0,2.0,1540,1.0,0,1120,420
895000.0,5.0,3.0,2876,1.0,2,1970,906
368250.0,3.0,2.5,2150,2.0,0,2150,0
249900.0,2.0,1.0,1140,1.0,0,1140,0
350000.0,3.0,1.5,980,1.0,0,980,0
175000.0,3.0,1.75,1230,1.0,0,1230,0
270000.0,3.0,1.75,1390,1.0,0,860,530
495000.0,3.0,3.5,2380,2.0,3,1670,710
330000.0,3.0,1.0,1250,1.0,0,1250,0
1003000.0,4.0,2.75,2290,2.0,0,2170,120
299800.0,2.0,1.0,790,1.0,0,790,0
299900.0,3.0,2.5,2720,2.0,0,2720,0
691000.0,4.0,2.75,2550,1.0,0,1700,850
195000.0,2.0,1.0,1080,1.0,0,1080,0
405000.0,3.0,1.75,2470,1.0,1,1570,900
360000.0,2.0,0.75,850,1.0,2,550,300
256750.0,3.0,2.5,1990,1.0,0,1570,420
332500.0,3.0,2.25,1800,2.0,0,1800,0
218000.0,3.0,1.0,1020,1.0,0,1020,0
589000.0,4.0,2.5,2910,2.0,2,2910,0
255000.0,3.0,1.5,1060,1.0,0,1060,0
668750.0,4.0,2.5,2340,1.0,2,1590,750
344500.0,4.0,2.75,1800,1.0,0,1050,750
452000.0,4.0,2.0,1660,1.0,0,850,810
246000.0,3.0,1.5,1780,1.0,0,1780,0
535000.0,2.0,1.0,1030,1.0,0,920,110
430000.0,3.0,1.0,1150,1.0,0,1150,0
520000.0,4.0,2.5,3290,2.0,0,3290,0
450000.0,2.0,1.0,1200,1.0,0,1070,130
220000.0,4.0,2.5,2160,2.0,0,2160,0
525000.0,3.0,1.0,1450,1.0,1,950,500
1220000.0,4.0,2.5,3240,2.0,0,2060,1180
540000.0,3.0,2.0,1470,2.0,0,1000,470
600000.0,4.0,2.5,2360,2.0,0,2360,0
600000.0,3.0,2.25,2230,2.0,0,2230,0
625000.0,4.0,2.5,2630,2.0,0,2630,0
150000.0,3.0,1.0,1010,1.0,0,1010,0
389999.0,3.0,2.25,1445,2.0,0,1300,145
285000.0,3.0,1.75,2380,1.5,0,1320,1060
744000.0,4.0,2.75,2830,2.0,0,2830,0
700000.0,4.0,2.5,3010,2.0,0,3010,0
318989.0,4.0,2.25,2000,1.0,0,2000,0
556000.0,3.0,2.25,2020,2.0,0,2020,0
275000.0,3.0,2.5,2030,2.0,0,2030,0
430000.0,3.0,2.75,2550,2.0,0,2550,0
300000.0,2.0,1.0,970,1.0,0,970,0
396450.0,3.0,1.75,1540,1.0,0,1540,0
700000.0,4.0,3.25,2780,2.0,0,2780,0
655000.0,4.0,3.5,2350,2.0,3,1670,680
1185000.0,3.0,2.25,2760,2.0,0,2760,0
413800.0,3.0,2.0,1440,1.0,0,1440,0
334990.0,4.0,2.5,2220,2.0,0,2220,0
1030000.0,3.0,4.0,3880,2.0,3,3700,180
1130000.0,4.0,3.25,3810,1.0,1,2680,1130
556000.0,3.0,3.0,1960,2.0,0,1600,360
360000.0,3.0,2.5,1530,3.0,0,1530,0
480000.0,4.0,2.25,3250,2.0,0,3250,0
324000.0,3.0,2.5,1750,2.0,0,1750,0
1050000.0,4.0,3.25,3440,2.0,0,3440,0
275000.0,1.0,0.75,1170,1.0,0,880,290
180000.0,3.0,1.0,870,1.0,0,870,0
749000.0,4.0,2.5,2930,2.0,0,2930,0
373500.0,2.0,1.0,800,1.0,0,800,0
770000.0,4.0,2.5,2350,2.0,0,2350,0
356000.0,2.0,1.75,1060,1.0,0,1060,0
625000.0,3.0,1.75,2060,1.0,0,1350,710
494400.0,2.0,1.75,1560,1.0,0,780,780
585000.0,4.0,1.75,3000,1.0,3,1500,1500
926300.0,3.0,1.5,1660,2.0,0,1660,0
600000.0,3.0,1.75,1650,1.0,0,1040,610
430000.0,4.0,3.0,3220,2.0,0,2450,770
307000.0,3.0,1.5,2320,1.0,0,2320,0
604700.0,4.0,2.75,2750,1.0,3,1720,1030
219900.0,3.0,1.0,910,1.0,0,910,0
270000.0,2.0,1.5,840,2.0,0,840,0
432000.0,3.0,2.25,1470,2.0,0,1090,380
361000.0,3.0,1.0,1100,1.5,4,1100,0
249950.0,2.0,1.0,940,1.0,0,940,0
320000.0,3.0,2.0,1110,1.0,0,1110,0
305000.0,4.0,1.75,2200,1.5,0,1400,800
235750.0,2.0,1.0,740,1.0,0,740,0
657000.0,4.0,1.75,2740,1.0,2,1370,1370
385000.0,3.0,1.0,1250,1.0,0,1250,0
389950.0,4.0,2.5,3140,2.0,0,3140,0
150000.0,2.0,1.0,820,1.0,0,820,0
254500.0,4.0,2.75,2570,2.0,0,1720,850
555000.0,4.0,2.25,2350,1.0,0,1430,920
1075000.0,4.0,3.0,3600,1.0,4,2100,1500
245000.0,4.0,2.0,1580,1.0,0,1040,540
319950.0,2.0,1.0,1070,1.0,2,1070,0
337000.0,3.0,1.0,1070,1.0,0,1070,0
492000.0,4.0,2.0,1640,2.0,0,1640,0
1170000.0,3.0,2.75,2890,2.0,3,2830,60
348580.0,3.0,1.0,1220,1.0,0,1220,0
180000.0,2.0,1.0,1400,1.0,0,900,500
400000.0,3.0,1.0,1040,1.0,0,1040,0
295000.0,4.0,2.0,980,1.0,0,980,0
910000.0,4.0,3.25,3340,1.5,0,2240,1100
431500.0,3.0,3.5,1900,2.0,0,1430,470
180000.0,4.0,1.5,1740,1.0,0,1020,720
677000.0,3.0,2.0,2000,1.0,0,1100,900
1180500.0,3.0,1.75,1610,1.0,0,1090,520
635700.0,4.0,2.5,3240,1.0,0,1860,1380
482000.0,5.0,2.25,2230,1.0,0,1320,910
168000.0,2.0,2.5,1160,2.0,0,1160,0
805000.0,4.0,2.75,2410,1.0,0,1410,1000
398000.0,2.0,1.0,590,1.5,0,590,0
665000.0,4.0,2.5,2600,2.0,0,2600,0
592500.0,4.0,3.0,2170,1.0,0,1370,800
940000.0,4.0,2.75,2080,1.5,0,2080,0
655000.0,4.0,2.5,2860,2.0,0,2860,0
622500.0,4.0,2.5,2980,2.0,0,2980,0
380000.0,2.0,2.5,1230,2.0,0,1060,170
648360.0,4.0,1.75,2260,1.0,1,1130,1130
432000.0,3.0,2.75,2200,1.0,0,1100,1100
1050000.0,4.0,2.5,3030,1.5,0,3030,0
353250.0,2.0,1.0,1060,2.0,0,1060,0
320000.0,3.0,2.25,998,2.0,0,798,200
349900.0,4.0,2.5,2052,2.0,0,2052,0
330000.0,4.0,3.5,3150,2.0,0,3150,0
408000.0,3.0,2.25,1950,1.0,0,1950,0
321000.0,3.0,2.25,1347,3.0,0,1347,0
1051000.0,4.0,3.75,3860,2.5,0,3860,0
359000.0,3.0,1.5,1360,3.0,0,1360,0
300000.0,5.0,2.5,2760,2.0,0,2760,0
380000.0,5.0,3.5,2420,2.0,0,2420,0
660000.0,3.0,2.5,2450,2.0,0,2450,0
355000.0,3.0,2.25,1280,3.0,0,1280,0
259000.0,3.0,2.5,1550,2.0,0,1550,0
353000.0,1.0,1.0,550,2.0,0,550,0
430000.0,2.0,2.5,1520,2.0,0,1240,280
460000.0,3.0,1.0,1670,1.5,0,1170,500
80000.0,1.0,0.75,430,1.0,0,430,0
782000.0,4.0,2.5,2380,2.0,0,2380,0
218000.0,3.0,1.0,960,1.0,0,960,0
325000.0,3.0,1.0,1920,1.0,2,1120,800
902000.0,4.0,2.25,2530,1.0,0,1570,960
556000.0,5.0,2.5,3840,2.0,0,3840,0
662990.0,3.0,1.75,1240,1.5,0,1240,0
225000.0,2.0,1.0,1300,1.5,0,1300,0
439950.0,4.0,2.5,2380,2.0,0,2380,0
175000.0,2.0,1.0,1300,1.0,0,1300,0
306000.0,2.0,1.0,780,1.0,0,780,0
235000.0,4.0,2.5,1810,1.0,0,1230,580
399500.0,3.0,1.75,2420,2.0,0,2420,0
478000.0,3.0,1.0,1280,1.5,0,1280,0
515000.0,2.0,1.0,1680,1.0,0,1140,540
550000.0,3.0,2.5,2510,2.0,0,2510,0
149000.0,3.0,1.0,1700,1.0,0,1700,0
526000.0,3.0,1.75,1680,1.0,0,960,720
625000.0,3.0,2.5,2600,1.0,0,2600,0
950000.0,5.0,3.25,3400,2.0,0,3400,0
377691.0,5.0,1.75,2120,1.0,0,1320,800
648475.0,4.0,2.75,2250,1.0,0,1200,1050
383000.0,3.0,1.0,1800,1.0,0,1200,600
535000.0,3.0,2.5,2210,2.0,0,2210,0
449950.0,3.0,2.0,1560,2.0,0,1560,0
465425.0,4.0,2.75,2430,1.0,0,2430,0
675000.0,4.0,2.5,2560,2.0,0,2560,0
599000.0,3.0,2.75,1960,1.5,0,1410,550
416000.0,3.0,1.5,1110,1.0,0,1110,0
595000.0,2.0,1.5,1030,1.0,0,830,200
200000.0,4.0,1.0,1350,1.0,0,1350,0
402000.0,3.0,2.0,1540,2.0,0,1540,0
433000.0,4.0,1.75,1830,1.0,0,1010,820
275000.0,4.0,1.5,1930,2.0,0,1930,0
410000.0,3.0,2.0,1650,1.5,0,1650,0
554820.0,4.0,2.0,3510,1.0,2,2210,1300
1325000.0,4.0,3.0,3370,1.0,3,1860,1510
735000.0,3.0,2.5,2390,2.0,0,2390,0
607000.0,3.0,1.0,1230,1.0,0,1230,0
258000.0,3.0,1.75,1620,1.0,0,1310,310
661254.0,4.0,4.0,2290,1.5,0,1690,600
945000.0,4.0,2.0,2840,1.0,0,1420,1420
132500.0,3.0,1.0,1080,1.0,0,1080,0
467100.0,3.0,1.75,1620,1.0,0,1190,430
641000.0,3.0,1.75,1620,1.0,0,940,680
350000.0,3.0,1.0,1010,1.0,0,1010,0
335000.0,4.0,2.5,1750,1.0,0,1240,510
440000.0,4.0,2.5,2560,1.0,0,1280,1280
464600.0,3.0,1.75,1120,1.5,0,1120,0
300000.0,2.0,1.0,1340,1.0,2,1340,0
670500.0,4.0,2.0,1590,1.0,0,1590,0
552000.0,3.0,1.0,1430,1.0,0,1080,350
244000.0,4.0,1.0,1450,1.0,0,1450,0
788600.0,4.0,2.75,3500,2.0,0,3500,0
445000.0,3.0,2.0,1630,1.0,0,1630,0
530000.0,4.0,1.75,1814,1.0,0,944,870
90000.0,2.0,1.0,580,1.0,0,580,0
585000.0,3.0,2.0,1670,1.5,0,1670,0
498000.0,2.0,2.0,1140,1.0,0,1140,0
379000.0,2.0,1.0,800,1.0,2,800,0
462000.0,3.0,1.75,1300,1.0,0,820,480
388000.0,4.0,2.5,2440,2.0,0,2440,0
255000.0,3.0,2.0,1490,1.5,0,1490,0
665000.0,3.0,2.75,1800,1.0,0,1320,480
550000.0,3.0,2.0,1830,1.0,0,1830,0
606000.0,3.0,1.0,1500,1.0,0,1000,500
334000.0,4.0,2.5,2210,1.0,2,1410,800
360000.0,3.0,2.0,1270,3.0,0,1270,0
235000.0,2.0,1.0,1140,1.5,0,1010,130
580000.0,3.0,2.5,1620,3.0,4,1470,150
355000.0,3.0,2.0,1220,3.0,0,1220,0
375000.0,2.0,2.5,750,2.0,0,750,0
372000.0,4.0,1.75,1960,1.0,0,1340,620
479000.0,3.0,1.0,1370,1.5,0,1370,0
501000.0,2.0,1.0,1010,1.0,0,1010,0
245000.0,3.0,1.75,1260,1.0,0,1260,0
496700.0,3.0,2.5,1740,2.0,0,1740,0
347000.0,4.0,1.5,2670,2.0,0,2670,0
199000.0,2.0,1.0,720,1.0,0,720,0
440500.0,3.0,2.5,2460,2.0,0,2460,0
820000.0,4.0,2.5,3670,2.0,0,3670,0
325000.0,4.0,3.5,2630,1.5,3,1640,990
195000.0,3.0,1.75,1570,1.0,0,1570,0
675000.0,3.0,3.0,2980,1.0,0,1820,1160
295000.0,3.0,2.5,1560,2.0,0,1560,0
355300.0,3.0,2.5,1620,1.0,0,1620,0
276000.0,3.0,1.0,1140,1.0,0,1140,0
460000.0,2.0,1.5,2730,1.0,0,1570,1160
880000.0,3.0,2.0,2130,1.0,0,2130,0
370000.0,3.0,2.5,1780,2.0,0,1780,0
346000.0,4.0,2.5,2100,2.0,0,2100,0
172500.0,3.0,1.0,1140,1.0,0,1140,0
379950.0,3.0,1.5,1690,1.0,0,1140,550
468000.0,2.0,1.0,1160,1.0,0,860,300
477000.0,4.0,2.75,1720,2.0,0,1720,0
529000.0,3.0,1.0,1210,1.5,0,1210,0
312000.0,3.0,1.5,1255,3.0,0,1255,0
326100.0,2.0,1.0,880,1.0,0,880,0
360000.0,3.0,1.0,1050,1.5,0,1050,0
438000.0,3.0,1.75,1650,1.0,0,1650,0
360000.0,3.0,1.0,1570,1.0,0,1570,0
1050000.0,4.0,2.5,2920,1.0,3,1470,1450
688000.0,4.0,3.0,3000,1.5,3,1970,1030
585000.0,3.0,1.75,1850,1.0,0,1850,0
265000.0,3.0,2.5,1440,1.0,0,1000,440
375000.0,3.0,1.75,1440,1.0,0,1440,0
326500.0,3.0,1.0,1810,2.0,0,1810,0
160000.0,2.0,1.0,1180,1.0,0,1180,0
735000.0,5.0,2.75,3390,2.0,0,3390,0
400000.0,2.0,1.0,1470,1.0,0,1470,0
800000.0,4.0,2.5,2680,1.0,0,1380,1300
949880.0,4.0,2.25,2290,2.0,0,2290,0
405000.0,3.0,1.75,1980,1.0,0,1310,670
399000.0,4.0,2.5,2870,2.0,0,2540,330
730001.0,3.0,2.0,1840,1.0,0,1010,830
260000.0,3.0,2.0,1630,1.0,0,1630,0
751750.0,2.0,2.0,1880,1.5,0,1880,0
325000.0,3.0,1.75,1780,1.0,0,1780,0
344950.0,4.0,2.0,2330,1.0,0,1400,930
457500.0,3.0,1.75,1840,1.0,0,1050,790
389000.0,5.0,2.0,2330,1.0,0,1190,1140
515000.0,4.0,2.5,3200,2.0,0,3200,0
732000.0,3.0,2.5,2330,2.0,4,1410,920
415000.0,3.0,2.25,1950,1.0,0,1350,600
535000.0,2.0,1.0,1040,1.0,0,1040,0
525000.0,5.0,3.0,2750,1.5,0,1750,1000
570000.0,3.0,1.75,1930,1.0,0,1930,0
283200.0,4.0,2.5,1982,2.0,0,1982,0
1100000.0,3.0,2.75,2640,1.5,0,1750,890
495000.0,4.0,2.25,1940,1.0,0,1430,510
292050.0,5.0,3.0,2840,1.0,0,1710,1130
415000.0,5.0,1.5,1900,1.0,0,1130,770
295832.0,5.0,1.0,1410,1.0,0,960,450
450000.0,4.0,2.5,2520,2.0,0,2520,0
857000.0,4.0,3.0,3720,2.0,0,3720,0
499950.0,3.0,3.5,1820,2.0,0,1430,390
465000.0,3.0,2.0,1560,1.0,0,1560,0
329000.0,3.0,1.0,1600,1.0,0,1150,450
475000.0,3.0,2.0,1230,1.0,0,1230,0
255000.0,3.0,1.0,960,1.0,0,960,0
435000.0,3.0,1.0,1270,1.5,2,1270,0
685000.0,3.0,2.5,2810,2.0,0,2810,0
715000.0,2.0,2.5,2160,1.0,0,2160,0
780000.0,3.0,3.0,2520,1.5,0,1560,960
345000.0,2.0,1.5,1180,2.0,0,990,190
355000.0,4.0,2.25,1810,2.0,0,1810,0
282000.0,3.0,2.5,1680,1.0,0,1240,440
244000.0,3.0,1.0,910,1.0,0,910,0
967500.0,3.0,3.75,3250,2.0,2,2370,880
375000.0,3.0,1.5,2000,1.0,0,1520,480
994000.0,3.0,2.25,2510,1.5,2,1810,700
313000.0,3.0,1.75,1320,1.0,0,1320,0
304000.0,3.0,1.0,900,1.0,0,900,0
675000.0,3.0,2.5,2540,2.0,1,2540,0
305000.0,4.0,1.0,2100,1.0,0,1050,1050
280000.0,3.0,1.0,1200,1.0,0,920,280
960000.0,5.0,4.0,3720,2.0,0,3720,0
500000.0,3.0,2.25,1760,2.0,0,1760,0
274950.0,3.0,1.75,1670,1.0,0,1320,350
455600.0,3.0,2.5,2420,2.0,0,2420,0
970000.0,5.0,3.0,3480,2.0,0,3480,0
312900.0,4.0,2.5,1630,2.0,0,1630,0
535000.0,4.0,2.5,2340,2.0,0,2340,0
427000.0,2.0,1.0,920,1.0,0,920,0
405000.0,2.0,1.0,910,1.0,0,910,0
480000.0,3.0,1.0,1150,1.0,2,1150,0
725000.0,3.0,1.5,2500,1.5,2,1450,1050
268000.0,4.0,2.0,1930,1.0,0,1030,900
488000.0,3.0,2.5,1590,3.0,0,1590,0
760000.0,4.0,2.5,3330,2.0,0,3330,0
754950.0,3.0,2.5,2610,2.0,0,2610,0
263900.0,3.0,2.5,1658,2.0,0,1658,0
460000.0,3.0,3.5,1600,2.0,0,1240,360
399950.0,3.0,3.0,1296,3.0,0,1296,0
370000.0,2.0,2.25,1280,2.0,0,1080,200
450800.0,4.0,3.25,2510,2.0,0,2510,0
627000.0,3.0,3.5,2710,2.0,0,1650,1060
495000.0,3.0,2.5,1750,3.0,0,1750,0
310000.0,3.0,1.0,1430,1.5,0,1430,0
215000.0,2.0,1.0,1320,1.0,0,1320,0
630000.0,4.0,2.5,2740,2.0,0,2740,0
267000.0,3.0,2.5,2495,2.0,0,2495,0
365000.0,3.0,1.5,1300,1.0,0,1300,0
544500.0,4.0,2.5,2230,1.0,0,1450,780
599000.0,4.0,2.75,2020,1.0,0,1010,1010
815000.0,4.0,2.25,2000,2.0,0,2000,0
254000.0,2.0,1.0,1060,1.0,0,1060,0
740000.0,2.0,1.75,2080,1.0,0,1080,1000
225000.0,3.0,2.0,2030,1.0,0,1220,810
925000.0,3.0,2.5,2690,2.0,0,1840,850
1285000.0,4.0,2.5,3240,1.0,0,2260,980
537000.0,3.0,2.5,1550,2.0,0,1550,0
335000.0,4.0,2.0,1480,1.0,0,740,740
840000.0,4.0,2.75,3040,2.0,0,2100,940
224000.0,3.0,1.5,1560,1.0,0,1040,520
395000.0,3.0,2.5,2250,2.0,0,2250,0
450000.0,3.0,1.0,1100,1.0,0,1100,0
681000.0,3.0,1.0,1700,1.5,0,1700,0
898000.0,5.0,1.5,2680,1.0,0,1450,1230
370000.0,3.0,1.0,800,1.0,0,800,0
429000.0,2.0,1.75,1350,1.0,0,1350,0
150000.0,3.0,1.0,820,1.5,0,820,0
555000.0,3.0,2.5,3160,2.0,0,2650,510
326000.0,3.0,2.75,1720,1.0,0,1720,0
225000.0,3.0,2.5,1680,2.0,0,1680,0
245100.0,3.0,1.75,1300,1.0,0,1300,0
665000.0,3.0,2.5,2190,2.0,0,2190,0
535000.0,3.0,2.5,1720,2.0,0,1720,0
305000.0,3.0,1.0,1160,1.0,0,1160,0
215000.0,3.0,1.75,1210,1.0,0,1210,0
432500.0,3.0,1.75,1980,1.0,0,1270,710
655000.0,4.0,2.5,2990,2.0,0,2990,0
266200.0,3.0,1.5,1430,1.0,0,1430,0
244615.0,3.0,2.5,2060,2.0,0,2060,0
370000.0,4.0,2.5,3090,2.0,0,3090,0
1175000.0,3.0,2.5,1970,1.0,4,1100,870
189000.0,2.0,2.0,1700,1.0,0,850,850
820000.0,3.0,2.5,2510,2.0,2,2510,0
438750.0,3.0,1.75,1610,1.0,0,1610,0
1210000.0,4.0,2.75,3650,2.0,2,2530,1120
600000.0,4.0,2.0,2510,1.0,0,2510,0
589000.0,3.0,1.0,1110,1.5,0,1110,0
590000.0,3.0,2.0,1650,2.0,0,1650,0
479900.0,3.0,2.0,1980,1.0,0,1980,0
210000.0,2.0,1.5,880,2.0,0,880,0
745000.0,3.0,1.75,1490,1.0,0,1140,350
840500.0,3.0,2.0,2520,1.5,0,1410,1110
420000.0,3.0,1.75,1820,1.0,0,1250,570
840000.0,4.0,2.5,3420,2.0,0,3420,0
681716.0,4.0,2.5,3150,2.0,0,3150,0
600000.0,3.0,1.75,1580,1.0,0,1150,430
380000.0,3.0,2.0,1660,1.0,0,1660,0
168500.0,3.0,1.0,1100,1.0,0,1100,0
355000.0,2.0,1.0,1270,1.0,0,960,310
277000.0,4.0,1.0,1450,1.0,0,990,460
236000.0,4.0,2.25,1830,1.0,0,1200,630
270000.0,3.0,1.75,1300,1.0,0,650,650
700000.0,2.0,1.75,2320,1.5,2,1720,600
425000.0,4.0,2.75,1680,1.0,0,1080,600
635000.0,3.0,2.5,2300,1.5,0,2000,300
510250.0,3.0,1.75,1400,1.0,0,870,530
960000.0,4.0,2.25,2410,2.0,2,1800,610
254000.0,3.0,2.0,1480,1.0,0,1480,0
299000.0,3.0,1.0,1390,1.5,0,1390,0
175000.0,2.0,1.0,830,1.0,0,830,0
157500.0,2.0,1.0,740,1.0,0,740,0
580000.0,5.0,2.0,1940,1.0,0,970,970
124740.0,3.0,1.0,1340,1.0,0,1340,0
285000.0,2.0,1.0,800,1.0,0,800,0
242000.0,3.0,1.75,1310,1.0,0,1310,0
840000.0,4.0,1.75,2330,2.0,0,1300,1030
474800.0,2.0,3.25,1400,3.0,0,1400,0
490000.0,4.0,2.5,2360,2.0,0,2360,0
465000.0,3.0,2.25,1840,2.0,0,1840,0
515000.0,4.0,2.5,2680,2.0,0,2680,0
430000.0,3.0,3.75,3890,1.0,2,2390,1500
253400.0,3.0,2.0,1400,1.0,0,1400,0
355000.0,3.0,2.5,2400,1.0,0,2400,0
740000.0,4.0,2.25,2920,2.0,0,2920,0
186950.0,2.0,2.0,1390,2.0,0,1390,0
306000.0,3.0,2.5,1680,2.0,0,1680,0
510000.0,4.0,1.5,2040,1.0,0,1020,1020
345000.0,2.0,1.0,1080,1.0,0,1080,0
875000.0,3.0,2.75,2280,1.0,0,1280,1000
499950.0,4.0,2.5,2798,2.0,0,2798,0
739000.0,3.0,2.5,2810,2.0,0,2810,0
363000.0,4.0,2.5,3753,2.0,0,3336,417
782000.0,4.0,3.5,3910,2.0,0,3130,780
325000.0,2.0,2.5,1050,2.0,0,1050,0
485000.0,4.0,1.0,1600,1.5,0,1600,0
452000.0,4.0,2.25,2590,1.0,0,1340,1250
264950.0,4.0,2.25,1720,1.0,0,1120,600
267500.0,3.0,1.75,1590,1.0,2,1090,500
565000.0,4.0,2.5,2440,2.0,0,2440,0
535000.0,3.0,2.5,1360,3.0,0,1310,50
389000.0,2.0,1.0,910,1.0,0,910,0
400000.0,4.0,1.5,1390,1.0,0,1140,250
264000.0,3.0,1.5,1470,1.0,0,1470,0
690000.0,4.0,2.5,2920,2.0,0,2920,0
695000.0,3.0,2.5,2390,2.0,0,2390,0
246500.0,3.0,1.5,1270,1.0,0,1270,0
230000.0,2.0,1.0,950,1.0,0,950,0
820000.0,4.0,2.25,2280,1.5,2,1960,320
145000.0,3.0,1.0,1010,1.0,0,1010,0
436500.0,2.0,1.0,1260,1.0,0,1040,220
672000.0,3.0,2.5,2620,2.0,0,2620,0
680000.0,3.0,2.25,2330,1.5,2,1520,810
750500.0,5.0,3.0,2170,1.5,0,1450,720
550000.0,5.0,2.0,2450,1.0,0,1240,1210
266500.0,4.0,1.75,1880,1.0,0,1180,700
619000.0,4.0,2.0,2300,1.5,0,1550,750
405000.0,3.0,2.0,1240,1.0,0,1240,0
300000.0,2.0,1.0,820,1.0,0,820,0
231000.0,4.0,2.0,1530,2.0,0,1530,0
790000.0,5.0,3.25,2900,1.0,0,1890,1010
400000.0,4.0,2.75,1240,1.0,0,800,440
450000.0,4.0,2.0,2240,1.0,0,1120,1120
595000.0,3.0,2.0,1480,1.0,0,750,730
332000.0,3.0,2.25,2270,1.0,0,1380,890
155000.0,3.0,1.0,1250,1.0,0,1030,220
400000.0,5.0,2.0,1930,1.0,0,1020,910
349000.0,4.0,1.75,1700,1.0,0,1120,580
529000.0,3.0,1.0,1590,1.0,0,1590,0
405000.0,5.0,1.75,1880,1.0,0,960,920
635200.0,4.0,1.75,1640,1.0,0,920,720
540000.0,3.0,1.5,2600,1.0,0,1400,1200
402000.0,2.0,1.0,710,2.0,0,710,0
329932.0,3.0,1.5,1460,1.0,0,1100,360
300000.0,3.0,2.5,2080,2.0,0,2080,0
525000.0,5.0,2.5,2630,2.0,0,2630,0
602500.0,4.0,2.5,2760,2.0,0,2760,0
400000.0,4.0,2.0,1670,1.0,0,1670,0
445000.0,4.0,1.75,1990,1.5,0,1190,800
525000.0,3.0,3.0,2600,1.5,3,1890,710
395000.0,2.0,1.0,1320,1.5,0,1320,0
510000.0,3.0,1.5,2240,2.0,0,1370,870
723000.0,4.0,2.25,1960,1.0,0,1290,670
672500.0,4.0,2.75,2620,2.0,0,2620,0
860000.0,3.0,2.5,2770,2.0,0,2770,0
475300.0,3.0,1.0,2110,1.0,0,1110,1000
295000.0,4.0,2.5,2290,2.0,0,2290,0
250000.0,2.0,1.0,1110,1.0,0,1110,0
658000.0,4.0,2.75,3310,2.0,0,3310,0
83000.0,2.0,1.0,900,1.0,0,900,0
685000.0,3.0,1.75,1940,1.0,1,1440,500
210000.0,3.0,1.75,1590,2.0,0,1590,0
650880.0,3.0,2.5,2930,2.0,0,2930,0
350000.0,4.0,2.5,2040,2.0,0,2040,0
305000.0,2.0,2.25,1000,3.0,0,1000,0
645000.0,3.0,3.25,1730,2.0,2,1320,410
385000.0,3.0,1.0,1220,1.0,0,1220,0
860000.0,3.0,2.25,3060,2.0,0,3060,0
395000.0,4.0,2.5,2910,2.0,0,2910,0
260000.0,3.0,1.75,1050,1.0,0,1050,0
196440.0,3.0,2.0,1560,1.0,0,1560,0
425000.0,3.0,1.75,1680,1.0,2,840,840
369000.0,3.0,2.0,1550,1.0,0,1150,400
349900.0,3.0,2.5,2200,2.0,0,2200,0
650000.0,2.0,2.5,1740,2.0,2,1210,530
299950.0,3.0,1.0,1210,1.0,0,1210,0
625000.0,4.0,3.25,4240,2.0,3,3550,690
190000.0,3.0,2.25,1590,1.0,0,1090,500
659000.0,4.0,2.5,3190,1.0,0,2210,980
490000.0,3.0,1.75,1920,1.0,2,960,960
415000.0,2.0,1.75,1340,1.0,0,1340,0
750000.0,3.0,1.75,1700,1.0,0,1460,240
700000.0,4.0,2.5,2310,1.5,0,1490,820
425000.0,3.0,1.75,1510,1.0,0,1240,270
642000.0,3.0,2.5,2670,1.0,0,2670,0
655000.0,4.0,2.25,2060,1.0,0,1440,620
458000.0,5.0,2.5,3090,1.0,0,2990,100
330000.0,2.0,2.5,1240,2.0,0,1240,0
384950.0,3.0,2.5,1860,2.0,0,1860,0
560000.0,3.0,1.5,2000,1.0,0,2000,0
465000.0,4.0,2.25,1820,1.0,0,1340,480
425000.0,3.0,2.25,1820,1.0,0,1260,560
315000.0,3.0,2.0,1060,1.0,0,1060,0
530000.0,3.0,2.5,1950,2.0,0,1950,0
399000.0,2.0,1.0,940,1.0,0,940,0
168000.0,2.0,1.5,1220,1.5,0,1220,0
374000.0,3.0,1.0,1200,1.0,0,1200,0
740000.0,5.0,3.75,3990,2.0,0,3090,900
280000.0,2.0,1.0,1880,1.0,0,940,940
322000.0,4.0,2.5,2280,2.0,0,2280,0
459900.0,3.0,1.75,2580,1.0,0,1290,1290
750000.0,4.0,2.75,2600,1.0,0,1560,1040
1256500.0,4.0,2.5,3150,2.0,0,3150,0
427000.0,5.0,2.75,2220,1.0,0,1230,990
800000.0,2.0,2.25,1730,2.0,2,1730,0
735000.0,4.0,3.0,2840,1.5,0,2060,780
642000.0,4.0,2.5,2560,2.0,0,2560,0
240000.0,3.0,2.0,1330,1.0,0,630,700
645500.0,2.0,1.0,1890,1.5,0,1890,0
325000.0,3.0,1.75,2180,1.0,0,1090,1090
825500.0,3.0,2.5,2780,2.0,0,2780,0
499431.0,4.0,2.75,2620,2.0,0,2620,0
919204.0,4.0,3.5,3760,2.0,0,2860,900
545000.0,4.0,2.5,2720,2.0,0,2720,0
660000.0,3.0,2.25,2675,2.0,0,2675,0
538888.0,5.0,2.75,2080,2.0,0,2080,0
693000.0,3.0,2.5,2460,2.0,0,2460,0
289950.0,3.0,2.5,1960,2.0,0,1960,0
587000.0,4.0,2.5,2550,2.0,0,2550,0
615000.0,3.0,2.25,1760,3.0,0,1760,0
459000.0,3.0,1.75,1620,1.0,0,1090,530
243000.0,3.0,1.75,1790,1.0,0,1040,750
660000.0,4.0,1.75,2780,2.0,0,2780,0
250000.0,1.0,1.0,750,1.0,0,750,0
315000.0,3.0,1.0,960,1.0,0,960,0
404000.0,3.0,1.5,2030,1.0,0,1330,700
559900.0,3.0,2.75,2930,1.0,0,1860,1070
285000.0,2.0,2.5,1380,2.0,0,1140,240
500000.0,3.0,2.0,1720,1.0,2,960,760
380000.0,2.0,1.0,1210,1.0,0,1060,150
469000.0,3.0,1.0,950,1.5,0,950,0
405000.0,2.0,1.75,1710,2.0,0,1330,380
439900.0,2.0,2.0,1410,1.5,0,1410,0
525000.0,4.0,2.5,2910,2.0,2,2910,0
580000.0,4.0,2.5,2220,2.0,0,2220,0
1250000.0,5.0,3.25,3160,2.0,0,3160,0
275000.0,3.0,2.0,1380,1.0,0,1380,0
629000.0,3.0,2.0,1760,1.0,0,960,800
395000.0,1.0,1.0,730,1.0,0,730,0
965000.0,4.0,2.5,2460,2.0,0,1620,840
820000.0,3.0,1.75,2160,1.0,0,1390,770
661000.0,4.0,2.25,1990,1.5,2,1420,570
789000.0,3.0,3.0,3740,2.0,2,3740,0
668500.0,4.0,2.5,2710,2.0,0,2710,0
350000.0,3.0,2.5,2680,2.0,0,2680,0
250000.0,4.0,2.0,1850,1.0,0,1540,310
725995.0,4.0,2.5,3190,2.0,2,3190,0
1000000.0,3.0,2.5,2730,2.0,0,2730,0
686000.0,3.0,1.5,1840,2.0,0,1840,0
665000.0,4.0,2.5,2720,2.0,0,2720,0
653000.0,3.0,2.5,2290,2.0,0,2290,0
430000.0,2.0,1.0,990,1.0,0,990,0
305000.0,2.0,1.5,1140,2.0,0,1140,0
809000.0,4.0,1.5,1840,2.0,0,1840,0
440150.0,2.0,1.0,1110,1.0,0,1000,110
615000.0,4.0,2.5,2150,2.0,0,2150,0
1035000.0,3.0,2.5,2230,2.0,0,2230,0
455000.0,2.0,1.0,1170,1.0,0,970,200
635000.0,3.0,2.5,1960,1.0,0,980,980
675000.0,3.0,2.25,2610,2.0,0,2610,0
316000.0,3.0,2.25,2130,1.0,0,1570,560
955000.0,3.0,2.25,3020,2.0,0,2720,300
985000.0,3.0,1.75,1670,2.0,0,1670,0
465500.0,3.0,1.75,1890,1.0,0,1290,600
305000.0,3.0,1.0,950,1.0,0,950,0
645000.0,4.0,2.5,2430,1.0,0,1670,760
730000.0,4.0,2.0,2360,1.0,0,1260,1100
366000.0,3.0,1.75,1510,1.0,0,1510,0
290000.0,3.0,2.5,2080,2.0,0,2080,0
472500.0,3.0,2.0,1750,1.0,0,1490,260
550000.0,3.0,2.0,1810,1.5,0,1810,0
410000.0,4.0,1.75,1790,1.0,0,1490,300
440000.0,4.0,2.75,2340,1.0,0,1720,620
535000.0,3.0,2.5,1690,2.0,0,1690,0
300000.0,4.0,2.5,2070,2.0,0,2070,0
432500.0,3.0,2.5,2240,2.0,0,2240,0
492000.0,3.0,1.75,2770,1.0,0,1580,1190
199950.0,3.0,1.0,1010,1.0,0,1010,0
439800.0,3.0,1.5,1120,1.0,0,1120,0
320000.0,5.0,2.5,3020,1.0,0,1510,1510
345000.0,3.0,1.75,1990,1.0,1,1320,670
274950.0,3.0,1.0,1450,1.0,0,1050,400
270000.0,4.0,2.5,1920,2.0,0,1920,0
342000.0,2.0,2.5,1175,2.0,0,740,435
327000.0,3.0,1.5,1320,1.0,0,1320,0
455000.0,2.0,1.0,1140,1.0,0,850,290
540000.0,4.0,1.75,1720,1.5,0,1460,260
411000.0,4.0,2.75,2150,1.0,0,1240,910
544000.0,3.0,1.5,1790,1.5,1,1790,0
802000.0,2.0,2.5,2210,1.0,0,2210,0
568500.0,3.0,2.75,2180,1.0,0,1310,870
391000.0,3.0,2.25,1410,2.0,0,1290,120
298000.0,3.0,2.5,1950,2.0,0,1950,0
400000.0,3.0,2.5,1495,3.0,0,1405,90
425000.0,3.0,2.25,1660,1.0,0,1110,550
328500.0,3.0,2.5,1950,2.0,0,1950,0
650000.0,5.0,2.75,2550,1.5,0,2550,0
850000.0,3.0,1.75,1370,1.0,0,770,600
930000.0,4.0,2.5,2200,2.0,0,1430,770
530000.0,3.0,1.75,1250,1.5,0,1250,0
495000.0,4.0,2.25,2220,1.0,0,1110,1110
500000.0,3.0,1.75,1620,1.0,0,830,790
325000.0,3.0,1.75,2250,1.0,0,2250,0
471000.0,4.0,2.5,3030,2.0,0,2020,1010
223000.0,3.0,1.0,1030,1.0,0,1030,0
503000.0,3.0,2.5,2190,2.0,0,2190,0
230000.0,3.0,2.0,1440,1.0,0,720,720
550000.0,4.0,2.5,2170,1.0,0,1460,710
1100000.0,4.0,3.75,2930,1.5,0,2130,800
193000.0,3.0,1.5,1180,1.0,0,1180,0
712500.0,3.0,1.5,1660,1.0,0,1660,0
689800.0,3.0,2.75,2390,1.0,0,1390,1000
430000.0,3.0,2.0,1360,1.5,0,910,450
785200.0,3.0,2.25,1840,1.5,0,1540,300
474900.0,3.0,2.25,1800,1.0,0,1800,0
941500.0,5.0,3.5,3490,2.0,4,2460,1030
312000.0,4.0,2.5,1830,2.0,0,1830,0
835000.0,4.0,2.75,1550,1.5,0,1550,0
713250.0,3.0,2.0,2050,1.0,0,2050,0
440000.0,2.0,1.0,1230,1.0,0,1130,100
580135.0,4.0,2.5,3150,2.0,0,3150,0
575000.0,3.0,2.25,3800,1.0,0,3330,470
613000.0,3.0,2.5,1350,2.0,0,1350,0
235000.0,3.0,2.0,1530,1.0,0,1530,0
660000.0,3.0,2.5,2290,3.0,0,2290,0
280000.0,2.0,1.5,1480,1.0,0,1480,0
268000.0,3.0,1.75,1970,1.0,0,1970,0
235000.0,2.0,1.0,720,1.0,0,720,0
390000.0,3.0,2.0,1080,1.0,0,1080,0
654950.0,4.0,2.5,2790,2.0,0,2790,0
449500.0,5.0,2.75,2040,1.0,0,1200,840
150000.0,3.0,1.0,1320,1.0,0,1320,0
710000.0,3.0,2.0,2140,1.0,0,1070,1070
420000.0,3.0,1.75,1660,1.0,0,1380,280
312000.0,3.0,2.25,1540,1.0,0,770,770
320000.0,3.0,2.0,1880,1.0,0,940,940
235000.0,3.0,1.0,1250,1.0,0,1250,0
545000.0,3.0,1.75,1810,1.5,0,1810,0
640000.0,3.0,2.5,2370,2.0,0,2370,0
432000.0,3.0,2.5,1970,2.0,0,1970,0
548000.0,3.0,2.5,2110,2.0,0,2110,0
830000.0,3.0,3.0,2080,1.5,0,2080,0
409950.0,2.0,1.75,1370,1.0,0,1370,0
695000.0,4.0,2.5,2961,2.0,0,2961,0
562100.0,3.0,2.25,2090,2.0,0,2090,0
475000.0,3.0,2.5,2600,2.0,0,2600,0
425000.0,3.0,2.25,1870,1.0,0,1440,430
600000.0,4.0,2.5,2620,2.0,0,2620,0
239000.0,3.0,1.75,1340,1.0,0,1340,0
295000.0,2.0,1.0,1170,1.0,0,1170,0
560000.0,3.0,1.75,2000,1.0,0,1400,600
613000.0,5.0,2.5,2070,1.0,0,1340,730
847000.0,5.0,1.0,2550,2.5,0,2550,0
206000.0,3.0,1.0,1060,1.0,0,1060,0
253000.0,2.0,1.75,1220,1.0,0,860,360
430000.0,4.0,2.25,1790,1.0,0,1110,680
605000.0,3.0,2.0,2060,1.0,0,1120,940
425000.0,2.0,2.5,1140,3.0,0,1140,0
720000.0,4.0,2.5,2870,2.0,0,2870,0
1298000.0,4.0,3.5,2790,1.5,0,2790,0
210000.0,3.0,1.0,1110,1.0,0,1110,0
234000.0,2.0,1.0,940,1.0,0,940,0
285000.0,3.0,1.75,2880,1.0,0,1580,1300
400000.0,3.0,1.5,1200,1.0,0,1200,0
718000.0,3.0,1.0,1030,1.0,0,1030,0
174500.0,2.0,2.5,1240,2.0,0,1240,0
222400.0,3.0,2.0,1200,1.0,0,1200,0
402500.0,3.0,3.25,2780,2.0,0,2780,0
250000.0,3.0,2.25,1765,2.0,0,1765,0
600000.0,4.0,2.5,1960,1.0,1,1290,670
930000.0,2.0,2.5,2680,1.0,0,2680,0
272500.0,3.0,2.0,1410,1.0,0,1410,0
363990.0,4.0,2.5,2240,2.0,0,2240,0
575000.0,4.0,2.75,3120,2.0,0,3120,0
400000.0,3.0,2.25,1450,2.0,0,1450,0
427874.0,3.0,3.0,2340,2.0,0,2340,0
309000.0,5.0,2.75,2481,2.0,0,2481,0
320000.0,3.0,3.25,1530,2.0,0,1140,390
390000.0,3.0,2.25,1250,1.0,0,1250,0
299000.0,1.0,0.75,560,1.0,0,560,0
375000.0,4.0,1.75,2200,1.0,0,1100,1100
240500.0,3.0,1.75,1460,1.0,0,990,470
320000.0,3.0,1.5,1650,1.0,0,1130,520
1270000.0,5.0,2.5,3200,1.0,0,2160,1040
658588.0,3.0,2.25,2560,2.0,0,2560,0
270000.0,3.0,2.25,2080,1.5,0,1550,530
327500.0,3.0,1.0,1070,1.0,0,1070,0
340000.0,3.0,1.75,2190,2.0,0,2190,0
200000.0,3.0,1.5,2060,1.5,0,2060,0
1025000.0,3.0,1.75,2640,1.0,3,1320,1320
275000.0,3.0,2.5,1720,1.0,0,1000,720
1126000.0,5.0,3.5,3880,2.0,3,2540,1340
280000.0,2.0,1.0,960,1.0,0,960,0
865000.0,3.0,1.75,2090,2.0,0,1610,480
532000.0,3.0,2.5,1820,2.0,0,1820,0
364950.0,4.0,2.5,2310,2.0,0,2310,0
212500.0,3.0,1.0,920,1.0,0,920,0
135000.0,1.0,1.0,790,1.0,0,790,0
437000.0,2.0,1.75,1500,1.0,0,910,590
390000.0,3.0,1.0,1240,1.0,0,1240,0
760000.0,4.0,2.5,2730,2.0,0,2730,0
119500.0,3.0,1.0,1170,1.0,0,1170,0
837500.0,4.0,2.5,2700,2.0,0,2700,0
327500.0,4.0,1.75,1650,1.0,0,1650,0
175000.0,2.0,1.0,670,1.0,0,670,0
289950.0,3.0,2.0,1670,1.0,0,1670,0
400000.0,3.0,1.75,1530,1.0,0,1530,0
219950.0,3.0,2.25,1500,1.0,0,1150,350
161700.0,4.0,1.75,1720,1.0,0,1220,500
500000.0,5.0,3.0,2920,2.0,0,2920,0
465000.0,3.0,1.0,910,1.0,0,910,0
540000.0,3.0,1.0,1050,1.0,0,1050,0
525000.0,3.0,2.0,1540,1.0,0,1540,0
324950.0,3.0,1.0,1210,1.0,0,1210,0
565000.0,5.0,2.5,2650,1.0,0,1400,1250
760500.0,3.0,2.0,1990,1.0,0,1130,860
1100000.0,5.0,2.75,2660,1.0,4,1470,1190
453500.0,5.0,2.5,2300,1.0,0,1170,1130
275000.0,2.0,1.0,770,1.0,0,770,0
875000.0,4.0,2.75,3790,2.0,0,3790,0
335000.0,4.0,2.75,2540,1.0,0,1600,940
646000.0,4.0,2.25,2500,1.0,0,1600,900
392500.0,4.0,2.5,2150,2.0,0,2150,0
785000.0,3.0,1.75,1670,1.0,0,1670,0
470000.0,3.0,2.0,1800,1.0,0,1800,0
560000.0,3.0,2.5,2070,2.0,0,2070,0
519000.0,2.0,1.0,830,1.0,0,830,0
746000.0,3.0,2.25,2370,1.0,0,1650,720
317000.0,3.0,1.0,1010,1.0,0,1010,0
371000.0,3.0,1.5,1420,1.0,0,1420,0
250000.0,4.0,2.0,2120,1.5,0,2120,0
532000.0,4.0,1.75,2020,1.0,0,1430,590
499950.0,3.0,2.5,1520,2.0,0,1040,480
375000.0,2.0,1.0,820,1.0,0,820,0
640000.0,3.0,2.5,1690,2.5,0,1690,0
400000.0,3.0,2.0,2260,1.0,0,1130,1130
572000.0,3.0,2.25,1830,1.0,0,1290,540
310000.0,3.0,2.0,1350,1.0,0,1110,240
989000.0,5.0,3.5,3280,2.0,0,2440,840
685000.0,4.0,2.5,2770,2.0,0,2770,0
907500.0,4.0,2.5,2770,2.0,0,2770,0
427500.0,4.0,2.5,2460,2.0,0,2460,0
365000.0,2.0,1.0,1250,1.0,0,1250,0
250500.0,3.0,2.0,1710,2.0,0,1710,0
411715.0,3.0,1.75,1840,1.0,0,1040,800
415000.0,4.0,2.5,2000,2.0,0,2000,0
129000.0,1.0,1.0,650,1.0,0,650,0
489000.0,3.0,1.5,1020,1.0,0,920,100
170000.0,2.0,1.0,1500,1.0,0,1500,0
418500.0,3.0,2.5,2060,2.0,0,2060,0
261000.0,3.0,1.5,1810,1.0,0,950,860
355000.0,2.0,1.75,1650,1.0,0,950,700
742000.0,3.0,3.25,1540,3.0,0,1540,0
399950.0,3.0,1.5,2080,1.0,0,1190,890
791000.0,3.0,2.25,2430,2.0,0,1810,620
190000.0,5.0,2.0,1750,1.0,0,1750,0
229500.0,3.0,1.75,1770,1.0,0,1770,0
539000.0,3.0,2.5,1710,2.0,0,1570,140
545000.0,5.0,2.5,2730,1.0,0,1660,1070
285000.0,3.0,2.5,2437,2.0,0,2437,0
648000.0,4.0,2.5,3290,2.0,0,3290,0
610000.0,4.0,3.5,2910,2.0,0,2910,0
767450.0,3.0,2.0,1630,1.0,0,1630,0
586500.0,3.0,2.5,1780,3.0,0,1600,180
520000.0,3.0,3.25,1540,2.0,0,1540,0
455000.0,3.0,1.75,1420,3.0,0,1420,0
653000.0,3.0,2.5,2680,1.0,0,1610,1070
279950.0,3.0,2.0,1750,1.0,0,1350,400
449950.0,3.0,2.5,2170,2.0,0,2170,0
565000.0,3.0,2.75,2390,1.0,0,1360,1030
620000.0,4.0,2.25,2400,1.5,0,1460,940
269000.0,3.0,1.0,1690,1.0,0,1020,670
875000.0,3.0,3.5,3250,2.0,0,2500,750
425000.0,4.0,2.75,2440,2.0,1,2440,0
647500.0,3.0,1.75,1290,1.0,0,1290,0
450000.0,4.0,1.0,2000,1.5,0,1250,750
440000.0,3.0,1.0,1050,1.0,0,1050,0
445000.0,4.0,2.5,2340,2.0,0,2340,0
530000.0,4.0,2.25,2210,2.0,0,2210,0
875000.0,5.0,2.5,2920,2.0,0,2320,600
798000.0,3.0,3.5,3590,2.0,0,3590,0
297500.0,4.0,2.5,1910,2.0,0,1910,0
749950.0,4.0,2.75,3110,2.0,0,3110,0
495000.0,5.0,3.0,2440,1.0,0,1450,990
540000.0,4.0,2.25,1330,1.5,0,1330,0
395000.0,3.0,1.75,1460,1.0,0,1460,0
214100.0,2.0,2.5,1150,2.0,0,1150,0
210000.0,4.0,1.5,1920,1.0,0,1370,550
546000.0,2.0,1.0,970,1.0,0,970,0
292000.0,5.0,2.5,2490,1.0,0,1490,1000
289000.0,3.0,2.0,1680,1.0,0,1680,0
240000.0,3.0,1.0,1150,1.0,0,1150,0
395000.0,4.0,3.0,1980,1.0,0,1160,820
795000.0,4.0,2.25,2070,1.0,0,1700,370
725000.0,4.0,2.75,2420,1.0,0,1530,890
335000.0,4.0,2.5,2610,2.0,0,2610,0
492000.0,4.0,3.75,2810,2.0,2,2070,740
250000.0,3.0,2.5,1510,1.0,0,1030,480
700000.0,3.0,1.75,1910,1.0,0,1080,830
555000.0,4.0,2.75,2020,1.0,0,1420,600
640000.0,3.0,1.75,2340,1.0,0,1170,1170
390000.0,3.0,2.0,1463,3.0,0,1463,0
466500.0,3.0,1.0,1430,1.0,0,950,480
372500.0,3.0,1.5,1180,1.0,0,800,380
255000.0,3.0,2.5,1610,2.0,0,1610,0
466800.0,3.0,2.5,1480,2.0,0,1480,0
749000.0,3.0,2.5,2670,2.0,0,2670,0
610000.0,4.0,1.75,1830,2.0,0,1230,600
356000.0,2.0,1.0,920,1.0,0,920,0
165000.0,3.0,1.0,1150,1.0,0,1150,0
229000.0,2.0,1.0,1190,1.0,0,830,360
530000.0,4.0,3.25,4160,2.0,0,2760,1400
499950.0,3.0,2.5,2370,2.0,0,2370,0
619000.0,4.0,1.75,1660,1.5,0,1660,0
547000.0,3.0,2.5,1480,1.0,0,1480,0
359800.0,4.0,2.5,2390,2.0,0,2390,0
499000.0,3.0,3.5,1690,2.0,0,1360,330
189000.0,3.0,1.0,1010,1.0,0,1010,0
799000.0,4.0,3.5,3500,2.0,0,2500,1000
257000.0,4.0,2.75,2330,1.0,0,1800,530
270000.0,3.0,1.5,1890,1.0,0,1090,800
453500.0,4.0,1.75,2000,1.0,2,1300,700
237000.0,3.0,1.0,1130,1.0,0,1130,0
456000.0,4.0,1.75,1670,1.0,0,1670,0
355500.0,3.0,2.5,2600,2.0,0,2600,0
299950.0,4.0,1.75,1560,1.0,0,1560,0
335000.0,3.0,2.0,1170,1.0,0,1170,0
268500.0,4.0,2.5,2100,2.0,0,2100,0
385000.0,3.0,2.25,1710,1.0,0,1210,500
376000.0,4.0,2.75,2420,2.0,0,2420,0
605004.0,4.0,2.0,1370,2.0,0,1370,0
886000.0,4.0,2.0,2660,1.5,0,1480,1180
560000.0,4.0,2.5,2260,2.0,0,2260,0
343000.0,4.0,2.5,2070,2.0,0,2070,0
270000.0,3.0,1.0,1500,1.0,0,1500,0
411605.0,4.0,2.5,2658,2.0,0,2658,0
550000.0,4.0,2.5,2700,2.0,0,2700,0
465000.0,3.0,2.25,1530,2.0,0,1050,480
584000.0,3.0,2.5,1480,2.0,0,1280,200
275000.0,3.0,3.0,1390,2.0,0,1140,250
324500.0,3.0,2.5,1660,2.0,0,1660,0
700000.0,3.0,2.5,2050,2.0,0,2050,0
385200.0,4.0,1.0,1550,1.5,0,1550,0
270000.0,4.0,2.25,1900,1.0,0,1900,0
735000.0,4.0,2.5,2820,2.0,0,2050,770
389250.0,2.0,1.5,1490,1.0,0,930,560
315000.0,3.0,1.5,1750,1.0,0,1150,600
545000.0,4.0,2.5,2040,2.0,0,2040,0
550000.0,3.0,1.5,1900,1.5,0,1640,260
415000.0,3.0,1.75,1910,1.0,0,1340,570
387500.0,3.0,1.0,1560,1.0,0,1560,0
432000.0,3.0,1.75,1470,1.0,3,1070,400
402000.0,3.0,2.5,2700,1.0,3,1350,1350
1035000.0,4.0,3.25,3450,2.0,3,2430,1020
294700.0,3.0,2.0,1970,1.0,0,1300,670
744000.0,3.0,2.5,2670,2.0,0,2670,0
715000.0,3.0,2.5,2550,2.0,0,2550,0
500000.0,4.0,1.0,1720,1.5,0,1720,0
1300000.0,4.0,4.0,4270,2.0,3,3180,1090
1150000.0,3.0,1.5,2170,1.0,2,1130,1040
650000.0,4.0,2.5,2840,2.0,0,2840,0
510000.0,3.0,1.75,1480,1.0,0,1480,0
525000.0,5.0,2.75,2440,1.0,0,1240,1200
920000.0,4.0,2.75,2880,1.5,0,1710,1170
200000.0,2.0,1.0,1730,1.0,0,1380,350
435000.0,2.0,1.0,1260,1.5,0,1260,0
809950.0,4.0,2.0,2230,1.5,0,2230,0
471000.0,3.0,2.5,2030,2.0,0,1720,310
253500.0,2.0,1.0,810,1.0,0,810,0
185000.0,3.0,1.0,1840,1.0,0,920,920
535500.0,3.0,1.5,1730,2.0,0,1730,0
835000.0,2.0,2.0,2280,1.0,0,2280,0
589500.0,4.0,2.5,2630,2.0,0,2630,0
680000.0,3.0,2.25,2270,1.0,0,1820,450
360000.0,3.0,1.75,1020,1.5,0,1020,0
595000.0,4.0,2.5,1990,2.0,0,1680,310
300000.0,4.0,2.5,2680,2.0,0,2680,0
660000.0,3.0,1.75,1980,1.5,0,1140,840
570000.0,3.0,2.5,2400,2.0,0,2400,0
285000.0,2.0,1.0,780,1.0,0,780,0
435000.0,3.0,2.0,980,1.0,0,980,0
450000.0,3.0,2.5,1480,2.0,0,1480,0
510000.0,4.0,1.5,1320,1.0,0,1320,0
1280000.0,4.0,3.5,3010,2.0,0,2370,640
539000.0,3.0,2.0,2260,1.0,0,1780,480
407193.0,4.0,2.0,1880,2.0,0,1880,0
320000.0,3.0,1.75,1370,1.0,0,1370,0
739000.0,4.0,3.0,2720,2.0,0,1800,920
452000.0,2.0,1.75,1740,1.0,0,990,750
600000.0,4.0,2.5,2560,2.0,0,2560,0
279000.0,5.0,2.5,2690,2.0,0,2690,0
895000.0,4.0,3.0,3240,2.0,0,3240,0
585000.0,4.0,2.5,2430,2.0,0,2430,0
405000.0,2.0,2.0,1405,2.0,0,1140,265
837219.0,5.0,2.75,3030,2.0,0,3030,0
490000.0,3.0,3.0,1730,3.0,0,1730,0
462000.0,4.0,2.5,3070,2.0,0,3070,0
540000.0,4.0,2.5,1780,2.0,0,1780,0
260000.0,4.0,2.5,1811,2.0,0,1811,0
567500.0,3.0,2.5,2300,2.0,0,2300,0
445000.0,2.0,1.0,1440,1.0,0,960,480
684680.0,4.0,2.25,2370,2.0,0,2370,0
455000.0,3.0,1.0,1300,1.5,0,1300,0
540000.0,5.0,3.0,2870,2.0,0,2090,780
530000.0,3.0,2.75,3400,2.0,2,2470,930
410000.0,3.0,1.0,1410,1.0,0,910,500
450000.0,3.0,1.75,1640,1.0,0,1110,530
609900.0,4.0,2.5,3190,2.0,0,3190,0
648000.0,4.0,2.5,2380,2.0,0,2380,0
550000.0,3.0,2.5,2260,2.0,0,2260,0
347000.0,3.0,1.75,1240,1.0,0,1240,0
1339000.0,4.0,2.5,4250,2.0,2,3260,990
288350.0,3.0,1.5,1860,1.0,0,1200,660
1150000.0,3.0,2.5,2850,1.0,0,1730,1120
525000.0,3.0,3.0,2470,2.0,0,2470,0
250250.0,3.0,2.25,2210,2.0,0,2210,0
341000.0,4.0,1.75,1920,1.0,0,1500,420
700000.0,4.0,3.0,3150,2.0,0,3150,0
390000.0,4.0,1.75,2700,1.5,0,2700,0
539950.0,3.0,2.25,2190,1.0,1,1240,950
552000.0,2.0,2.5,1380,3.0,0,1380,0
250000.0,5.0,1.5,2520,1.5,0,1510,1010
502000.0,3.0,1.75,1300,1.0,0,1300,0
480000.0,4.0,1.75,2220,2.0,3,2220,0
378500.0,2.0,1.0,730,1.0,0,730,0
1350000.0,4.0,3.25,3300,2.0,0,3300,0
605000.0,3.0,2.5,2670,2.0,3,2670,0
307550.0,4.0,2.5,1980,2.0,0,1980,0
304700.0,2.0,1.0,740,1.0,0,740,0
568000.0,3.0,1.75,2050,1.0,0,1070,980
385000.0,3.0,1.75,1230,1.0,0,1230,0
345000.0,3.0,2.5,1210,3.0,0,1210,0
435000.0,3.0,2.25,1890,1.0,0,1230,660
579000.0,2.0,2.0,1870,1.0,0,1870,0
236000.0,3.0,1.75,1330,1.0,0,1330,0
305100.0,3.0,2.0,1590,1.0,0,1590,0
368000.0,3.0,1.75,1710,1.0,0,1710,0
255000.0,2.0,1.0,1200,1.0,2,1200,0
400000.0,2.0,1.0,1140,1.0,0,1140,0
440000.0,3.0,1.75,2240,1.0,0,1120,1120
417000.0,2.0,1.0,920,1.0,0,920,0
435000.0,2.0,1.0,800,1.0,0,800,0
475000.0,4.0,2.75,1980,1.0,0,1980,0
563500.0,4.0,2.5,2800,2.0,0,2800,0
285000.0,3.0,2.25,1680,2.0,0,1680,0
471000.0,4.0,2.5,2330,2.0,0,2330,0
500000.0,4.0,1.75,2240,1.5,0,2240,0
640000.0,3.0,2.5,2140,2.0,0,2140,0
442500.0,4.0,2.5,2170,2.0,0,2170,0
213400.0,3.0,1.5,1150,1.0,0,1150,0
831000.0,4.0,2.5,2030,1.5,0,1630,400
325000.0,3.0,2.0,1350,1.0,0,1350,0
425000.0,2.0,1.0,910,1.0,0,910,0
550000.0,4.0,2.5,2700,1.0,0,1440,1260
599950.0,4.0,3.5,3730,2.0,2,2440,1290
1225000.0,4.0,2.5,2740,2.0,0,2740,0
750000.0,4.0,3.25,2050,2.0,0,1370,680
290000.0,4.0,3.0,2390,2.0,0,2390,0
270000.0,4.0,2.75,1990,1.0,0,1270,720
229950.0,4.0,1.75,1300,1.0,0,1300,0
234999.0,3.0,1.0,1330,1.0,0,1330,0
265000.0,2.0,1.0,1000,1.0,0,1000,0
367300.0,4.0,2.75,2190,2.0,0,2190,0
550000.0,3.0,1.75,1380,1.5,0,1380,0
743700.0,4.0,2.5,2610,2.0,0,2610,0
352750.0,2.0,1.75,1060,2.0,0,960,100
403950.0,2.0,1.0,710,2.0,0,710,0
980000.0,4.0,2.5,2730,1.5,0,2230,500
554000.0,3.0,1.75,1760,1.0,0,1760,0
546000.0,3.0,2.5,1530,2.0,0,1530,0
212500.0,2.0,2.0,1030,1.0,0,1030,0
428000.0,3.0,2.0,1310,1.0,0,780,530
965000.0,4.0,2.25,3160,1.0,0,3160,0
364900.0,3.0,3.0,2500,2.0,0,2500,0
559000.0,3.0,1.5,2070,1.0,0,1140,930
213000.0,4.0,1.75,1980,1.0,0,1480,500
620000.0,3.0,2.5,2590,2.0,0,2590,0
240000.0,4.0,1.0,1910,1.5,0,1910,0
852500.0,3.0,2.5,2630,1.0,0,1580,1050
410000.0,3.0,2.5,1960,2.0,0,1960,0
328000.0,3.0,1.75,1440,2.0,0,1440,0
625000.0,3.0,1.75,2210,1.0,0,1390,820
235000.0,3.0,1.0,1590,1.5,0,1590,0
489000.0,3.0,3.5,1500,2.0,0,1240,260
536000.0,3.0,2.5,1900,2.0,0,1900,0
400000.0,4.0,3.5,2370,2.5,0,2370,0
398000.0,3.0,2.5,1720,2.0,0,1240,480
379000.0,4.0,1.5,2020,1.0,0,2020,0
345000.0,2.0,1.5,1340,2.0,0,1120,220
365000.0,3.0,2.5,1800,2.0,0,1800,0
315000.0,3.0,2.5,1480,2.0,0,1150,330
571000.0,4.0,2.0,2750,1.5,0,2250,500
1025000.0,5.0,4.0,3760,2.0,0,3760,0
695000.0,3.0,2.75,2540,2.0,0,2540,0
225000.0,3.0,1.75,1760,1.0,0,920,840
740000.0,3.0,2.5,3000,2.0,0,3000,0
315000.0,4.0,2.5,1930,2.0,0,1930,0
1230000.0,4.0,2.5,3040,2.0,0,3040,0
420000.0,2.0,1.0,860,1.0,0,860,0
310000.0,3.0,1.75,1420,1.0,0,1100,320
700000.0,3.0,2.0,2080,1.0,0,1160,920
269000.0,3.0,2.5,1560,2.0,0,1560,0
369990.0,4.0,2.5,1960,2.0,0,1960,0
800000.0,3.0,2.25,1620,2.0,0,1620,0
440000.0,3.0,1.5,1290,3.0,0,1290,0
435000.0,5.0,2.25,1970,1.0,0,1450,520
345000.0,3.0,1.75,1540,1.0,0,920,620
558000.0,4.0,2.0,2180,1.0,0,1020,1160
490000.0,3.0,2.0,2220,2.0,0,1640,580
335000.0,3.0,1.75,2430,1.0,0,1410,1020
350000.0,2.0,0.75,1392,1.5,0,1392,0
100000.0,4.0,1.0,1120,1.0,0,860,260
417500.0,4.0,1.0,1390,1.5,0,1390,0
253000.0,3.0,1.75,2040,1.0,0,1020,1020
1240000.0,5.0,3.0,2830,2.0,0,2460,370
490000.0,4.0,2.5,3020,2.0,0,3020,0
470000.0,3.0,1.75,2290,1.0,0,1620,670
483300.0,4.0,2.0,1210,1.0,0,1210,0
659000.0,3.0,2.5,2510,2.0,0,2510,0
480000.0,4.0,1.75,2320,1.0,0,1140,1180
165000.0,3.0,1.0,970,1.0,0,970,0
659500.0,3.0,1.75,1820,1.0,0,1620,200
219900.0,3.0,1.0,970,1.0,0,970,0
315000.0,2.0,1.0,1740,1.0,0,950,790
250000.0,3.0,1.75,1590,1.0,0,1130,460
268000.0,2.0,1.0,1380,1.0,0,870,510
380000.0,4.0,1.5,1680,1.0,0,1130,550
499000.0,2.0,1.0,1220,1.0,0,920,300
285000.0,2.0,2.0,1651,1.0,0,1651,0
183000.0,3.0,1.75,1330,1.0,0,1330,0
1070000.0,3.0,3.0,2940,2.0,0,2230,710
429000.0,3.0,3.25,1410,3.0,0,1410,0
403000.0,2.0,1.0,1100,1.0,0,1100,0
375500.0,3.0,1.5,1530,1.0,0,1530,0
516200.0,3.0,2.0,2110,1.0,0,1080,1030
385000.0,4.0,1.75,1720,1.0,0,860,860
515000.0,3.0,2.5,1800,2.0,0,1800,0
375000.0,4.0,2.5,2210,2.0,0,2210,0
650000.0,4.0,2.25,2560,2.0,0,2560,0
306888.0,2.0,1.5,1010,2.0,0,1010,0
870000.0,4.0,2.5,3340,2.0,1,2470,870
310000.0,4.0,1.0,1740,1.5,0,1740,0
251750.0,3.0,2.0,1320,1.0,0,1320,0
366000.0,3.0,1.75,1520,1.0,0,1520,0
429950.0,3.0,1.5,2010,1.0,0,1570,440
710000.0,3.0,3.5,2440,2.0,0,1990,450
895000.0,5.0,2.5,2550,1.0,0,1610,940
149500.0,3.0,1.0,1010,1.0,0,1010,0
310000.0,3.0,2.5,1780,1.0,0,1230,550
555000.0,3.0,2.0,2180,1.5,2,1680,500
750000.0,5.0,3.25,2750,2.0,1,2150,600
745000.0,4.0,3.25,3490,2.0,0,3490,0
695000.0,3.0,2.5,2550,2.0,0,2550,0
433000.0,3.0,1.75,1870,1.0,0,1270,600
307000.0,4.0,1.0,1150,1.5,0,1150,0
655275.0,3.0,1.75,2050,1.0,0,1460,590
392000.0,4.0,2.75,1940,2.0,0,1940,0
1180000.0,5.0,3.75,3630,1.5,0,2470,1160
359950.0,3.0,1.75,1890,2.0,0,1890,0
360000.0,4.0,2.0,1630,1.0,0,1630,0
566000.0,4.0,1.75,2440,1.0,0,1340,1100
700000.0,5.0,2.75,3100,2.0,2,3100,0
415000.0,3.0,2.5,2090,2.0,0,2090,0
199500.0,3.0,1.0,920,1.0,0,920,0
749000.0,3.0,1.0,1580,1.5,0,1580,0
680000.0,3.0,1.75,1760,1.0,0,1460,300
400000.0,4.0,2.5,2530,1.0,0,1440,1090
608000.0,4.0,2.75,2490,1.0,0,1400,1090
480000.0,5.0,2.5,2732,1.0,2,1870,862
1059500.0,5.0,3.25,3230,2.0,0,2480,750
695000.0,4.0,3.5,3510,2.0,0,3510,0
899900.0,4.0,2.5,2580,2.0,0,2580,0
499950.0,2.0,2.25,1060,2.0,0,940,120
533112.0,4.0,2.75,2790,2.0,0,2790,0
303210.0,4.0,2.5,2009,2.0,0,2009,0
525000.0,5.0,2.75,2880,2.0,0,2880,0
399950.0,2.0,1.0,710,2.0,0,710,0
850830.0,3.0,2.5,2070,1.5,0,1270,800
371500.0,3.0,2.0,1370,1.0,0,1370,0
522000.0,3.0,1.75,1730,1.0,0,1400,330
588000.0,4.0,2.0,1680,1.0,0,980,700
276900.0,2.0,1.0,1350,1.0,2,1350,0
248000.0,5.0,1.5,1510,1.0,0,1510,0
280000.0,3.0,2.5,1860,2.0,0,1860,0
290300.0,2.0,1.0,860,1.0,0,860,0
527000.0,2.0,1.75,1640,1.0,0,840,800
487028.0,2.0,1.5,1295,2.0,0,1105,190
325000.0,3.0,1.75,1790,1.0,0,1130,660
799000.0,3.0,1.5,2210,1.5,0,2210,0
354000.0,3.0,1.0,940,1.0,0,940,0
262500.0,3.0,1.5,1160,1.0,0,1160,0
560200.0,3.0,2.5,1990,2.0,0,1990,0
220000.0,3.0,1.0,1050,1.0,0,1050,0
650000.0,2.0,1.0,1030,1.0,0,1030,0
435000.0,3.0,2.5,1420,3.0,0,1420,0
800000.0,4.0,3.75,2690,2.0,3,2120,570
1010000.0,4.0,2.5,3760,2.0,0,3760,0
200000.0,2.0,1.0,700,1.0,0,700,0
295000.0,5.0,3.5,2100,2.0,0,1410,690
580379.0,4.0,2.75,2240,1.5,0,2240,0
875000.0,4.0,2.5,3470,2.0,0,3470,0
515000.0,3.0,2.5,3370,2.0,0,3200,170
285000.0,3.0,2.5,1870,2.0,0,1870,0
290000.0,3.0,1.75,1520,1.0,0,1520,0
355000.0,1.0,1.75,750,1.0,0,550,200
381000.0,3.0,1.5,1460,1.0,0,1460,0
571000.0,3.0,2.5,2600,2.0,0,2600,0
852600.0,4.0,2.5,3320,2.0,0,2650,670
1085000.0,5.0,2.5,2340,2.0,0,2340,0
371000.0,3.0,1.0,890,1.0,0,890,0
514000.0,3.0,1.75,1720,1.0,1,1220,500
386000.0,3.0,1.5,1270,2.0,0,1080,190
464000.0,4.0,2.5,2180,2.0,0,2180,0
335000.0,4.0,2.25,2030,1.0,0,1230,800
740000.0,4.0,2.75,2490,2.0,2,1490,1000
465000.0,4.0,1.75,1470,1.0,0,980,490
700000.0,3.0,2.75,2500,1.0,0,1390,1110
350000.0,3.0,3.25,1460,2.0,0,1130,330
148000.0,1.0,1.0,620,1.0,0,620,0
530000.0,3.0,1.75,1550,1.0,0,1050,500
349000.0,3.0,2.5,1430,3.0,0,1430,0
240000.0,3.0,1.5,1360,1.5,0,1360,0
330000.0,3.0,2.5,2210,2.0,0,2210,0
735000.0,4.0,1.75,2460,1.5,0,1450,1010
545000.0,3.0,2.5,2180,1.0,0,1850,330
214950.0,3.0,1.75,1570,1.0,0,1310,260
476000.0,3.0,1.0,1140,1.5,0,1140,0
110000.0,2.0,1.0,800,1.0,0,800,0
292000.0,4.0,2.75,2414,2.0,0,2414,0
317000.0,3.0,1.0,1160,1.0,0,1160,0
455000.0,4.0,2.5,3170,2.0,2,3170,0
460000.0,3.0,2.0,2060,1.0,0,1030,1030
405000.0,3.0,2.0,1640,1.0,0,1640,0
333000.0,2.0,1.0,720,1.0,0,720,0
742000.0,4.0,2.5,2810,2.0,0,2810,0
465000.0,4.0,2.5,2090,1.0,0,1320,770
809950.0,4.0,2.5,3280,2.0,0,3280,0
619400.0,4.0,2.0,2090,1.5,0,1790,300
762400.0,3.0,1.75,2430,1.0,1,1230,1200
881000.0,5.0,3.0,2510,1.5,3,1590,920
813000.0,4.0,2.75,3370,1.0,3,1920,1450
234000.0,3.0,2.0,1640,1.5,0,1640,0
308900.0,3.0,2.5,2250,2.0,0,2250,0
450000.0,4.0,2.5,2300,1.0,0,2300,0
547500.0,3.0,3.5,1650,3.0,0,1650,0
399950.0,2.0,1.0,710,2.0,0,710,0
516000.0,4.0,3.5,2550,2.0,0,2550,0
250000.0,2.0,1.5,982,2.0,0,806,176
475000.0,3.0,2.25,1630,2.0,0,1630,0
415000.0,4.0,2.5,2550,2.0,0,2550,0
545000.0,2.0,1.25,1240,2.0,0,1240,0
329950.0,3.0,2.5,2456,2.0,0,2456,0
610750.0,4.0,2.25,2180,2.0,0,2180,0
578000.0,4.0,2.5,3140,1.0,2,1770,1370
501000.0,3.0,1.75,1970,1.0,3,1370,600
465250.0,5.0,2.0,1940,1.5,0,1940,0
315000.0,2.0,1.0,970,1.0,0,970,0
900000.0,4.0,2.25,2460,1.0,0,2460,0
789500.0,4.0,2.5,3010,2.0,0,3010,0
678500.0,3.0,2.0,2460,1.0,2,1370,1090
342500.0,3.0,2.0,2080,1.0,0,2080,0
860000.0,4.0,3.25,3960,2.0,0,3960,0
306000.0,4.0,2.5,2490,2.0,0,2490,0
580000.0,5.0,2.0,2060,2.0,0,2060,0
405000.0,3.0,1.0,1330,1.0,0,900,430
510000.0,3.0,1.75,1600,1.0,0,1600,0
173000.0,2.0,1.0,820,1.0,0,820,0
210000.0,4.0,1.75,1200,1.0,0,1200,0
445000.0,3.0,1.0,1050,1.0,0,910,140
585000.0,3.0,2.5,1910,2.5,0,1530,380
381000.0,3.0,1.75,1800,1.0,0,900,900
890000.0,3.0,2.25,2060,1.0,0,2060,0
235000.0,3.0,1.75,1840,1.0,0,1500,340
480000.0,3.0,2.5,1250,3.0,2,1250,0
575000.0,2.0,1.0,1510,1.5,0,1310,200
350000.0,4.0,2.25,2300,1.5,0,1340,960
259000.0,4.0,1.5,1490,2.0,0,1490,0
599000.0,5.0,2.75,2820,1.0,0,1450,1370
210000.0,4.0,1.5,1130,1.0,0,1130,0
1184000.0,4.0,2.5,3200,1.5,1,1860,1340
545000.0,3.0,1.0,1510,1.5,0,1510,0
299995.0,3.0,2.5,1970,2.0,0,1970,0
440000.0,3.0,1.0,1210,1.5,0,1210,0
699000.0,4.0,2.5,3280,2.0,0,3280,0
795000.0,3.0,2.0,2420,1.0,1,1500,920
445000.0,5.0,1.75,2460,1.5,0,1340,1120
397990.0,3.0,1.0,1180,1.0,0,1180,0
706000.0,3.0,2.75,1900,1.0,0,1410,490
363000.0,3.0,3.25,1651,2.0,0,1341,310
850000.0,4.0,2.25,2130,2.0,0,2130,0
620000.0,2.0,1.0,1430,1.5,0,1300,130
333000.0,4.0,2.5,1910,1.0,0,1910,0
743000.0,3.0,1.75,2110,1.0,0,2110,0
448000.0,2.0,1.5,1630,1.0,0,890,740
485000.0,4.0,2.5,2470,2.0,0,2470,0
489950.0,4.0,2.25,2640,1.0,0,2640,0
498500.0,5.0,2.75,2990,2.0,0,2990,0
531000.0,3.0,2.5,2120,2.0,0,2120,0
670000.0,3.0,2.5,2050,1.0,3,1730,320
310000.0,5.0,3.0,1880,1.0,0,1100,780
835000.0,3.0,3.0,2790,2.0,4,1600,1190
495000.0,4.0,2.5,2140,2.0,0,2140,0
495000.0,3.0,2.0,1769,1.0,0,1769,0
440000.0,3.0,1.0,1710,1.5,0,1200,510
280000.0,1.0,0.75,420,1.0,0,420,0
1070000.0,4.0,2.5,3270,2.0,0,3270,0
1034500.0,4.0,2.5,2370,2.0,0,2370,0
248000.0,4.0,2.5,1770,2.0,0,1770,0
294000.0,4.0,2.5,2210,1.0,0,1490,720
561000.0,3.0,2.25,1710,2.0,0,1710,0
656500.0,4.0,2.0,2710,1.0,0,1460,1250
660000.0,3.0,3.0,2340,2.0,0,2160,180
370000.0,2.0,1.0,1220,1.0,0,1220,0
349950.0,3.0,1.0,1060,1.0,0,1060,0
223000.0,2.0,1.0,910,1.0,0,910,0
560000.0,4.0,1.75,1880,1.5,0,1090,790
594000.0,4.0,1.75,1870,2.0,0,1200,670
600000.0,3.0,2.25,1480,2.0,0,1480,0
315000.0,3.0,2.5,1880,2.0,0,1880,0
430000.0,4.0,1.75,1890,1.0,0,1110,780
440000.0,3.0,2.75,1560,1.0,0,1030,530
312500.0,2.0,1.5,1070,2.0,0,1070,0
300000.0,3.0,3.25,1470,2.0,0,1180,290
680000.0,3.0,2.5,2570,2.5,0,2570,0
336750.0,2.0,2.25,1170,2.0,0,1170,0
822500.0,5.0,3.5,2320,2.0,0,1720,600
589000.0,4.0,3.0,2440,2.0,0,2440,0
210000.0,2.0,1.75,1440,1.0,0,1440,0
206135.0,3.0,1.0,1340,1.0,0,1340,0
285000.0,3.0,1.75,1840,1.0,0,920,920
230000.0,2.0,1.0,930,1.0,0,930,0
350000.0,3.0,1.75,1820,1.0,0,1230,590
304000.0,3.0,1.0,1280,1.5,0,1280,0
370000.0,2.0,1.0,900,1.0,0,900,0
810000.0,3.0,1.75,1980,1.0,2,1320,660
440000.0,4.0,2.25,2010,1.0,0,1220,790
1030000.0,4.0,2.5,2750,2.0,0,1960,790
775000.0,4.0,2.0,3140,1.0,1,1940,1200
1335000.0,5.0,2.25,4200,2.5,0,2910,1290
235000.0,3.0,1.75,1900,1.0,0,950,950
499950.0,3.0,1.0,1830,1.5,0,1430,400
622500.0,5.0,2.75,3320,2.0,0,2190,1130
300000.0,4.0,2.5,2700,1.0,0,1560,1140
205000.0,3.0,1.0,1290,1.0,0,1290,0
435000.0,3.0,1.75,1500,1.0,0,1500,0
697000.0,4.0,2.75,3650,1.5,0,3650,0
153000.0,3.0,1.0,1270,1.5,0,1270,0
454000.0,4.0,2.25,2630,2.0,0,2630,0
345000.0,2.0,1.5,1800,1.0,0,1240,560
585000.0,3.0,1.0,1870,1.5,0,1580,290
380000.0,4.0,2.5,2540,2.0,0,1870,670
250600.0,4.0,2.5,1930,1.0,0,1120,810
890000.0,4.0,2.25,2770,2.0,0,2770,0
370000.0,4.0,2.5,2220,2.0,0,2220,0
369500.0,3.0,1.5,1650,1.0,0,1100,550
950000.0,4.0,2.5,3770,2.0,0,3770,0
615000.0,3.0,1.75,2350,1.0,0,1800,550
305000.0,3.0,1.5,1210,1.0,0,610,600
590000.0,4.0,2.5,2010,2.0,0,2010,0
485000.0,3.0,2.5,1580,2.0,0,1580,0
215000.0,2.0,1.0,710,1.0,0,710,0
430000.0,3.0,2.0,1910,1.5,0,1910,0
324900.0,4.0,2.5,1880,2.0,0,1880,0
975000.0,5.0,2.75,3100,1.0,2,1660,1440
910000.0,5.0,2.5,2350,2.0,0,2350,0
459950.0,3.0,1.75,1850,1.0,2,1100,750
325000.0,3.0,2.5,2070,2.0,0,2070,0
513000.0,4.0,2.75,2020,1.0,0,1010,1010
475000.0,3.0,2.25,1580,1.0,0,1200,380
419000.0,4.0,2.5,2690,2.0,0,2690,0
760000.0,4.0,2.5,2420,1.0,4,1700,720
1120000.0,5.0,1.5,2540,2.0,3,2340,200
129000.0,2.0,1.0,1150,1.0,0,1150,0
725000.0,5.0,2.5,3210,1.0,0,1830,1380
580000.0,3.0,2.5,2040,2.0,0,2040,0
385000.0,3.0,2.25,1920,1.0,0,1060,860
265000.0,4.0,1.75,1900,1.0,0,1900,0
330000.0,3.0,2.5,1070,2.0,0,720,350
665000.0,4.0,2.5,2790,2.0,0,2790,0
799000.0,3.0,2.5,2860,2.0,0,2860,0
589000.0,3.0,2.0,2250,1.0,0,1250,1000
538000.0,3.0,1.0,1460,1.0,0,1260,200
530100.0,3.0,1.0,1540,1.5,0,1200,340
718500.0,3.0,2.0,2910,2.0,0,1920,990
299000.0,3.0,1.75,1180,1.0,0,1180,0
556000.0,3.0,1.75,1640,1.0,0,1090,550
171000.0,4.0,2.0,1520,1.0,0,1020,500
540000.0,5.0,3.0,3610,2.0,0,3610,0
250000.0,3.0,2.25,1400,2.0,0,1400,0
795000.0,4.0,3.5,3200,2.0,0,2670,530
575000.0,3.0,3.0,1384,2.0,0,1144,240
379500.0,3.0,2.25,1410,2.0,0,1290,120
385000.0,4.0,2.5,2050,2.0,0,2050,0
415500.0,4.0,2.5,1750,2.0,0,1750,0
397500.0,3.0,2.0,1510,1.0,0,1070,440
530000.0,3.0,2.5,1930,2.0,0,1930,0
883000.0,4.0,2.5,2960,2.0,0,2960,0
850000.0,5.0,2.75,2920,1.0,0,1660,1260
496752.0,2.0,1.0,1980,1.0,0,1090,890
330000.0,3.0,1.75,1430,1.0,0,1430,0
735000.0,4.0,2.75,2450,2.0,2,2450,0
525000.0,4.0,2.75,2360,2.0,0,2360,0
269950.0,3.0,2.5,1890,2.0,0,1730,160
650000.0,3.0,1.75,2140,1.0,0,1290,850
520500.0,3.0,2.0,1900,1.0,0,950,950
652500.0,4.0,2.5,2700,2.0,0,2700,0
506000.0,5.0,3.0,2430,1.0,0,1370,1060
416000.0,3.0,1.0,1110,1.0,0,1110,0
500000.0,4.0,2.75,2280,1.0,0,2280,0
460000.0,3.0,1.75,1550,1.0,0,860,690
371025.0,3.0,2.0,1530,1.0,0,1530,0
576000.0,4.0,2.5,2440,2.0,0,2440,0
353500.0,4.0,2.25,1760,2.0,0,1760,0
183000.0,3.0,1.75,1070,1.0,0,1070,0
763101.0,3.0,1.75,1990,1.0,0,1100,890
460000.0,2.0,1.5,1090,1.0,0,970,120
825000.0,4.0,1.5,1890,1.5,0,1890,0
265000.0,3.0,1.0,1000,1.0,0,1000,0
295000.0,3.0,1.75,1770,1.0,0,1030,740
418000.0,4.0,3.0,2360,1.0,2,1460,900
534500.0,3.0,2.5,1700,2.0,0,1700,0
690000.0,2.0,1.75,1600,1.0,0,850,750
530000.0,4.0,2.5,2050,2.0,0,2050,0
357186.0,2.0,1.75,1210,2.0,0,1210,0
300000.0,5.0,3.0,1940,1.0,0,1200,740
304000.0,4.0,2.0,1810,1.0,0,1110,700
385000.0,4.0,1.75,1690,1.0,0,870,820
415000.0,4.0,2.0,1800,1.0,0,1000,800
963000.0,4.0,3.5,3280,2.0,0,3280,0
309212.0,3.0,1.75,1150,1.0,0,1150,0
235000.0,2.0,1.5,880,2.0,0,880,0
667000.0,3.0,1.5,1720,2.0,0,1720,0
470000.0,3.0,1.5,1510,1.0,0,1510,0
375000.0,4.0,2.0,1240,1.0,0,1040,200
410000.0,4.0,2.0,1580,1.0,0,1580,0
566000.0,4.0,2.25,2170,2.0,0,2170,0
680000.0,4.0,2.75,2500,2.0,0,2500,0
332000.0,1.0,1.0,960,1.0,0,760,200
902000.0,4.0,2.5,3030,2.0,0,3030,0
500000.0,3.0,1.75,1540,1.0,0,770,770
445000.0,3.0,1.75,1890,1.5,3,1890,0
825000.0,4.0,2.5,2810,1.0,0,1710,1100
1095000.0,4.0,4.0,3530,2.0,0,2630,900
277000.0,3.0,1.0,1100,1.0,0,1100,0
545000.0,3.0,2.5,1940,1.0,2,1440,500
435000.0,3.0,2.5,2300,2.0,0,2300,0
638000.0,3.0,2.5,2110,2.0,0,2110,0
418000.0,4.0,1.5,1220,1.0,0,1220,0
499000.0,3.0,1.75,1750,1.0,0,1470,280
150000.0,3.0,1.5,1230,1.0,0,1230,0
759950.0,3.0,2.5,3100,2.0,0,3100,0
632500.0,5.0,2.5,2640,2.0,0,2640,0
862000.0,4.0,2.5,3190,2.0,0,3190,0
524000.0,2.0,1.0,1120,1.5,0,1120,0
470000.0,3.0,1.5,1760,1.0,0,1160,600
385000.0,3.0,2.0,1590,2.0,0,1590,0
575000.0,4.0,2.5,2120,2.0,0,2120,0
220000.0,4.0,2.5,2240,1.0,0,1370,870
460000.0,2.0,1.0,890,1.0,0,760,130
175000.0,3.0,1.5,1220,1.0,0,1220,0
465000.0,3.0,2.25,2670,1.0,0,1640,1030
552000.0,3.0,1.0,1120,1.0,0,820,300
518000.0,4.0,2.5,1740,1.0,0,1220,520
899950.0,4.0,3.5,3290,2.0,1,2360,930
373000.0,3.0,1.0,1770,1.5,0,1140,630
385000.0,4.0,2.5,2960,2.0,0,2960,0
245000.0,2.0,1.0,1200,1.0,0,980,220
375000.0,4.0,2.0,2400,2.0,0,2400,0
699850.0,4.0,3.5,2690,2.0,0,2690,0
455000.0,2.0,1.5,1310,1.5,0,1310,0
650000.0,4.0,2.75,2610,3.0,0,1910,700
378000.0,5.0,2.5,2760,1.0,0,1600,1160
220000.0,3.0,2.0,1410,1.0,0,1410,0
285500.0,4.0,1.75,1960,1.0,0,1960,0
340000.0,3.0,2.5,1212,3.0,0,1212,0
921000.0,4.0,1.5,2220,1.0,0,1490,730
999000.0,4.0,2.75,2800,2.0,0,2800,0
335000.0,3.0,1.5,2040,1.0,0,1340,700
385000.0,2.0,1.0,830,1.0,3,830,0
850000.0,4.0,3.5,4140,2.0,0,3160,980
429000.0,5.0,2.5,2340,2.0,0,2340,0
523950.0,3.0,2.25,1420,3.0,0,1420,0
798800.0,3.0,2.75,2670,1.0,0,1720,950
284000.0,3.0,2.5,1880,2.0,0,1880,0
852880.0,4.0,3.25,3450,2.0,0,3450,0
320000.0,3.0,2.25,1200,3.0,0,1200,0
749995.0,4.0,3.25,3430,2.0,0,3430,0
468500.0,3.0,2.5,1350,2.0,0,1120,230
492500.0,5.0,2.5,2570,2.0,0,2570,0
685000.0,4.0,3.5,2840,3.0,0,2840,0
542525.0,4.0,2.5,2650,2.0,0,2650,0
435000.0,3.0,2.0,1980,3.0,0,1980,0
242000.0,3.0,1.75,1280,1.5,0,1280,0
325000.0,4.0,2.5,2610,2.0,0,2610,0
837700.0,5.0,2.75,3010,2.0,0,3010,0
210000.0,1.0,1.0,930,1.0,0,930,0
187500.0,3.0,1.5,1180,1.0,0,1180,0
560000.0,5.0,1.0,1710,1.5,0,1320,390
272000.0,3.0,2.0,1380,1.0,0,1380,0
235000.0,3.0,1.75,1190,1.0,0,1190,0
259000.0,3.0,2.0,1870,1.0,0,1270,600
866059.0,5.0,3.5,3130,2.0,0,2570,560
473000.0,2.0,1.0,900,1.0,0,900,0
405000.0,3.0,1.5,1880,1.0,0,1480,400
475000.0,3.0,2.25,2280,1.0,1,1150,1130
499500.0,3.0,2.5,2970,2.0,0,2970,0
386000.0,2.0,2.5,1620,2.0,0,1620,0
458000.0,4.0,1.5,1550,1.5,0,1350,200
605500.0,3.0,2.5,2830,2.0,0,2830,0
421000.0,3.0,2.5,2890,2.0,0,2890,0
536000.0,4.0,2.25,1990,2.0,0,1990,0
247200.0,3.0,1.75,1370,1.0,0,1370,0
250000.0,2.0,1.5,1088,2.0,0,1088,0
204950.0,4.0,1.75,1740,1.0,0,1180,560
430000.0,3.0,2.0,1730,1.0,0,1370,360
250000.0,4.0,2.5,1800,2.0,0,1800,0
260000.0,3.0,1.75,1440,1.0,2,1090,350
547000.0,4.0,1.0,1720,1.5,0,1200,520
379900.0,5.0,3.5,2800,2.0,0,2800,0
738500.0,3.0,2.5,2300,1.0,0,2300,0
545000.0,4.0,2.25,2030,1.0,0,1590,440
342000.0,2.0,1.0,740,1.0,0,740,0
170000.0,4.0,1.0,1920,1.0,0,1220,700
616000.0,4.0,2.5,2490,2.0,0,2490,0
640000.0,3.0,2.0,1380,1.0,0,1380,0
332000.0,3.0,2.5,1530,1.0,0,1270,260
1010000.0,3.0,3.25,2420,2.0,2,1840,580
380000.0,4.0,2.5,2150,2.0,0,2150,0
415000.0,4.0,2.0,1610,1.0,0,1610,0
1008000.0,4.0,3.5,2650,2.0,0,2060,590
669000.0,4.0,2.75,2700,2.0,0,2700,0
260000.0,3.0,1.5,1270,1.0,0,1150,120
854000.0,4.0,2.75,3150,1.0,0,2480,670
605000.0,3.0,2.25,2010,2.0,0,2010,0
320000.0,3.0,1.0,860,1.5,0,860,0
229950.0,3.0,2.0,1410,1.0,0,1410,0
255000.0,3.0,1.75,1700,1.0,0,1700,0
1170000.0,4.0,2.5,2570,2.0,0,2570,0
479000.0,2.0,2.25,1230,2.0,0,1020,210
472000.0,3.0,2.5,1180,3.0,0,1180,0
198000.0,3.0,1.5,1430,1.0,0,820,610
440000.0,4.0,2.0,1450,1.5,0,1450,0
506000.0,3.0,1.75,2180,1.0,0,1480,700
382500.0,4.0,2.5,2210,2.0,0,2210,0
269500.0,2.0,1.5,1480,1.0,0,940,540
560000.0,3.0,2.0,2340,1.0,1,1170,1170
840000.0,4.0,3.5,3860,2.0,0,3120,740
479500.0,3.0,2.75,2300,2.0,0,2300,0
402000.0,3.0,1.5,1450,1.0,0,1010,440
549000.0,2.0,2.5,1380,3.0,0,1380,0
449950.0,4.0,2.5,2470,2.0,0,2470,0
493000.0,4.0,1.75,2030,1.5,0,2030,0
142500.0,4.0,0.75,1440,1.0,0,1440,0
250000.0,3.0,1.75,1160,1.0,0,1160,0
729000.0,3.0,1.0,1580,2.0,0,1580,0
465000.0,2.0,2.75,1430,2.0,0,995,435
465000.0,2.0,2.0,1494,2.0,4,1494,0
280000.0,4.0,2.25,1930,1.0,0,1360,570
667500.0,3.0,2.0,1880,1.0,0,1030,850
809000.0,3.0,2.5,2590,2.0,0,2590,0
400000.0,3.0,2.25,2140,2.0,0,2140,0
310000.0,4.0,2.0,1870,1.5,0,1870,0
435000.0,2.0,1.0,1230,1.0,0,1230,0
465950.0,4.0,2.5,2340,2.0,0,2340,0
253000.0,3.0,1.5,880,1.0,0,880,0
330000.0,3.0,2.5,3040,2.0,0,3040,0
554000.0,4.0,1.0,1120,1.5,0,1120,0
350000.0,3.0,2.0,1380,3.0,0,1380,0
294999.0,4.0,2.5,1660,2.0,0,1660,0
1185001.0,3.0,2.75,2500,2.0,0,2500,0
752000.0,4.0,2.5,2940,2.0,0,2940,0
451000.0,4.0,2.5,1670,2.0,0,1670,0
725000.0,4.0,2.75,2630,2.0,0,2630,0
345000.0,4.0,2.75,2250,1.0,0,1480,770
206000.0,3.0,1.0,1320,1.0,0,1320,0
580000.0,5.0,2.0,2700,1.0,0,1540,1160
430000.0,3.0,1.0,980,1.0,0,980,0
720000.0,4.0,2.5,2650,2.0,0,2110,540
936000.0,3.0,1.75,2960,1.0,2,1480,1480
535000.0,4.0,2.75,3070,2.0,0,3070,0
286800.0,3.0,2.5,1413,2.0,0,1413,0
350000.0,2.0,2.5,1260,3.0,0,1260,0
345000.0,3.0,2.5,1680,2.0,0,1680,0
435000.0,3.0,2.25,1230,2.0,0,1080,150
461000.0,3.0,3.25,2770,2.0,0,1980,790
770000.0,3.0,2.25,2910,2.0,0,2910,0
330000.0,3.0,2.5,1600,2.0,0,1600,0
322500.0,4.0,2.5,1820,2.0,0,1820,0
475000.0,3.0,1.75,1700,1.0,0,1230,470
250275.0,2.0,1.0,790,1.0,0,790,0
274500.0,3.0,2.25,1720,1.0,0,1320,400
284950.0,3.0,1.0,990,1.0,0,990,0
264950.0,4.0,1.75,1770,1.0,0,1050,720
242000.0,3.0,2.0,1260,1.0,0,1260,0
913000.0,4.0,2.5,3640,2.0,0,3640,0
555000.0,3.0,1.75,2040,1.0,0,1120,920
711000.0,4.0,1.75,1980,1.0,0,990,990
403500.0,5.0,2.5,3600,1.0,0,2410,1190
253779.0,4.0,2.0,2030,1.5,0,1430,600
384400.0,3.0,3.25,1689,3.0,0,1689,0
646000.0,5.0,2.75,2870,1.0,0,1650,1220
415000.0,3.0,1.75,1270,1.0,0,1270,0
764000.0,4.0,2.5,2790,2.0,0,2790,0
507000.0,5.0,3.25,3850,2.0,2,3030,820
545500.0,3.0,2.5,1560,1.5,0,1360,200
450000.0,3.0,1.75,1180,1.0,0,760,420
264000.0,4.0,1.75,1820,1.0,0,1080,740
650000.0,5.0,1.75,1260,1.5,0,1260,0
365000.0,3.0,2.5,2640,2.0,0,1680,960
343566.0,2.0,1.0,1100,1.0,0,1100,0
375000.0,3.0,2.5,1950,2.0,0,1950,0
295000.0,3.0,2.0,1380,1.0,0,1380,0
325000.0,3.0,2.75,2200,1.0,0,1280,920
265000.0,4.0,1.5,2050,1.0,0,1050,1000
562000.0,5.0,3.0,2795,2.0,0,2795,0
540000.0,4.0,2.5,2050,2.0,0,2050,0
279950.0,5.0,1.75,2150,1.0,0,1460,690
540000.0,3.0,1.75,1970,1.0,0,1420,550
310000.0,4.0,2.5,2660,1.0,0,1740,920
190000.0,1.0,1.0,720,1.0,0,720,0
440000.0,4.0,2.5,2410,2.0,0,2410,0
230000.0,2.0,1.0,1080,1.0,0,1080,0
455000.0,3.0,1.75,1180,1.0,0,1180,0
175000.0,2.0,1.0,660,1.0,0,660,0
650000.0,3.0,1.75,2920,1.0,0,1620,1300
192500.0,3.0,1.0,1080,1.5,0,1080,0
239950.0,3.0,1.75,1670,1.0,0,1170,500
850000.0,5.0,3.5,3450,1.0,0,2350,1100
410000.0,4.0,2.0,1970,1.0,0,1820,150
570000.0,4.0,2.5,2290,2.0,0,2290,0
469000.0,5.0,2.5,2240,1.0,0,1140,1100
559000.0,2.0,1.0,1240,1.0,1,1060,180
739888.0,3.0,2.5,2420,2.0,4,1690,730
240000.0,2.0,1.0,670,1.0,0,670,0
574950.0,5.0,3.25,3160,2.0,0,3160,0
180000.0,3.0,2.25,1990,2.0,0,1990,0
300000.0,3.0,2.5,1700,2.0,0,1700,0
630000.0,4.0,2.5,2807,2.0,0,2807,0
507000.0,4.0,1.75,1770,1.0,0,1170,600
287500.0,4.0,2.5,2570,1.0,0,1590,980
688000.0,3.0,3.0,3450,2.0,0,3450,0
424000.0,3.0,2.0,1670,1.0,0,1170,500
400000.0,3.0,1.75,1050,1.5,0,950,100
620000.0,4.0,2.5,1910,2.0,0,1910,0
300000.0,3.0,1.0,910,1.0,0,910,0
615000.0,5.0,2.25,2480,2.0,0,2480,0
206000.0,2.0,1.5,1820,2.0,0,1820,0
515500.0,4.0,2.5,2920,2.0,0,2920,0
554000.0,5.0,2.25,1870,1.0,0,1170,700
825000.0,4.0,3.5,3810,2.0,0,3810,0
855000.0,4.0,2.25,2190,2.0,0,1800,390
315000.0,3.0,2.5,1730,2.0,0,1730,0
299000.0,5.0,2.5,2220,1.0,0,1110,1110
650000.0,3.0,1.5,1320,1.0,0,1320,0
465000.0,3.0,1.75,1510,1.0,2,860,650
535000.0,3.0,2.0,2120,2.0,0,2120,0
564000.0,2.0,2.0,1690,1.0,0,1690,0
515000.0,3.0,3.5,1360,2.0,0,1040,320
580000.0,4.0,2.5,3250,2.0,0,3250,0
309000.0,3.0,2.25,1490,2.0,0,1220,270
536751.0,3.0,1.75,1930,1.0,0,1930,0
415000.0,4.0,2.5,2020,2.0,0,2020,0
267000.0,3.0,2.25,1584,2.0,0,1584,0
820000.0,4.0,2.5,3170,2.0,0,3170,0
485000.0,2.0,2.5,1430,3.0,0,1410,20
482000.0,3.0,3.25,1380,3.0,0,1380,0
535000.0,4.0,2.5,2610,2.0,0,2610,0
690000.0,3.0,3.25,1540,3.0,0,1540,0
576000.0,3.0,2.5,1940,1.0,0,970,970
378750.0,3.0,2.5,2160,1.5,0,1260,900
269900.0,4.0,1.75,1530,1.5,0,1530,0
210000.0,3.0,2.0,1440,1.0,0,1440,0
429900.0,4.0,2.5,2640,2.0,0,2640,0
360000.0,4.0,2.5,2850,2.0,0,2850,0
405000.0,2.0,1.0,1260,1.0,0,1260,0
450000.0,3.0,1.75,1610,1.0,0,1610,0
703000.0,3.0,2.0,1360,1.5,0,1360,0
661000.0,4.0,2.5,2496,2.0,0,2496,0
580000.0,4.0,2.25,2160,1.0,0,2160,0
464000.0,3.0,1.0,1320,2.0,0,1320,0
945000.0,2.0,2.5,2540,2.0,0,2540,0
659500.0,4.0,3.0,2620,1.0,0,1870,750
200000.0,3.0,1.5,1140,1.0,0,1140,0
280000.0,3.0,2.0,1790,1.0,0,1790,0
1325000.0,4.0,2.5,2440,2.5,0,2440,0
346150.0,3.0,2.0,2140,1.0,0,1480,660
197500.0,3.0,1.0,1330,2.0,0,1330,0
799000.0,4.0,2.5,2590,2.0,0,2590,0
350000.0,2.0,1.0,1620,1.0,0,850,770
720000.0,4.0,2.5,2440,2.0,0,2440,0
519000.0,3.0,2.75,2020,1.0,0,1270,750
590300.0,3.0,1.5,1470,2.0,0,1470,0
437000.0,2.0,1.75,1440,1.0,0,1440,0
221000.0,3.0,2.25,1640,1.0,0,1140,500
380000.0,4.0,2.25,2150,1.0,0,1090,1060
506000.0,2.0,1.0,1570,1.0,0,1150,420
395000.0,4.0,1.0,1980,1.0,0,1430,550
285000.0,3.0,1.0,1210,1.5,0,1210,0
311000.0,3.0,1.75,1900,1.5,0,1070,830
435000.0,3.0,1.75,1310,1.0,0,1310,0
120000.0,2.0,1.0,990,1.0,0,990,0
186000.0,3.0,2.0,1340,1.0,0,920,420
756000.0,4.0,2.25,2160,1.0,0,1080,1080
248000.0,4.0,2.0,2080,1.0,0,1040,1040
287000.0,3.0,2.0,1300,1.5,0,1300,0
510000.0,4.0,2.5,2610,2.0,0,2610,0
249000.0,3.0,1.0,1050,1.0,0,1050,0
340000.0,3.0,2.5,2480,2.0,0,2480,0
399888.0,4.0,2.25,1820,1.5,0,1320,500
440000.0,3.0,1.75,1170,1.0,0,1170,0
899000.0,4.0,2.25,2370,1.0,2,1440,930
540500.0,5.0,3.75,3090,2.0,0,3090,0
385000.0,3.0,1.75,2310,1.0,0,1630,680
558000.0,4.0,2.25,2060,1.0,0,1320,740
450000.0,4.0,2.5,2400,2.0,0,2400,0
232500.0,3.0,1.0,1320,1.0,0,880,440
436000.0,2.0,1.0,790,1.0,0,790,0
240000.0,4.0,2.0,1790,1.0,1,1670,120
489950.0,3.0,2.25,1820,2.0,0,1820,0
352450.0,3.0,2.0,1430,1.0,0,1430,0
549000.0,4.0,1.75,1290,2.0,0,1290,0
1240000.0,4.0,3.5,3820,2.0,0,3280,540
618250.0,4.0,3.25,2520,1.5,0,1550,970
850000.0,2.0,1.75,1590,1.5,3,1320,270
930000.0,5.0,2.0,3530,1.5,0,3530,0
505000.0,3.0,2.5,1610,2.0,0,1610,0
275000.0,3.0,1.75,1860,1.0,0,1860,0
499000.0,3.0,1.75,1840,1.0,0,920,920
507000.0,3.0,2.5,2120,2.0,0,2120,0
619850.0,4.0,2.5,2270,1.0,0,1500,770
500000.0,3.0,2.5,2840,1.0,3,1870,970
310000.0,4.0,1.5,1220,1.0,0,1220,0
646000.0,4.0,2.5,2310,2.0,0,2310,0
265000.0,3.0,1.75,1840,1.0,0,1840,0
475000.0,3.0,2.5,950,2.0,0,950,0
600000.0,4.0,2.25,3070,2.0,0,3070,0
470000.0,3.0,2.0,1730,1.0,0,1730,0
319950.0,2.0,1.0,920,1.0,0,920,0
712000.0,3.0,2.75,3200,2.0,0,3200,0
775000.0,4.0,2.75,3010,2.0,0,3010,0
390000.0,3.0,2.25,1600,1.0,0,1090,510
585000.0,4.0,2.5,2840,2.0,0,2840,0
1027000.0,3.0,2.5,2430,2.0,1,2430,0
232603.0,3.0,1.75,1750,2.0,0,1750,0
543000.0,3.0,2.25,1240,3.0,0,1240,0
607500.0,3.0,3.25,1530,3.0,0,1530,0
750000.0,3.0,3.5,3390,2.0,0,3040,350
728050.0,3.0,2.5,2320,1.0,0,2320,0
734990.0,4.0,2.5,2650,2.0,0,2650,0
330000.0,3.0,2.5,2238,2.0,0,2238,0
605000.0,4.0,2.5,2620,2.0,0,2620,0
441000.0,3.0,2.75,1910,1.0,0,1160,750
650000.0,4.0,2.5,3040,2.0,0,3040,0
395000.0,3.0,1.0,1500,1.0,0,900,600
245000.0,1.0,0.75,380,1.0,0,380,0
905000.0,4.0,3.5,2970,2.0,0,2340,630
660000.0,4.0,3.25,3030,2.0,0,3030,0
378000.0,4.0,2.5,1890,1.0,0,1230,660
600000.0,2.0,1.0,1040,1.0,0,1040,0
632500.0,4.0,2.5,2090,2.0,0,2090,0
210000.0,2.0,2.0,1680,2.0,0,1680,0
754800.0,2.0,2.5,2770,2.0,0,2770,0
175000.0,2.0,1.0,1020,1.0,0,1020,0
455000.0,3.0,2.25,1470,2.0,0,1470,0
450000.0,3.0,2.0,1430,1.0,0,980,450
790000.0,4.0,1.75,2050,1.0,3,1450,600
480000.0,4.0,1.0,2080,1.0,0,1040,1040
850000.0,3.0,2.25,2870,2.0,0,2250,620
725000.0,4.0,3.25,3940,2.0,3,3440,500
380000.0,3.0,1.5,1520,1.0,0,1020,500
979000.0,3.0,1.5,1700,1.0,1,1700,0
359950.0,3.0,2.25,1940,1.0,0,1100,840
665900.0,4.0,2.25,2870,2.0,1,2220,650
812000.0,3.0,3.25,3240,2.0,0,3240,0
203000.0,3.0,1.0,1150,1.0,0,1150,0
456000.0,3.0,1.5,1440,1.0,0,1440,0
547000.0,5.0,2.5,2200,1.5,0,1420,780
280000.0,3.0,2.0,1470,1.0,0,1470,0
640000.0,2.0,1.75,1760,1.0,0,880,880
477000.0,3.0,1.75,1780,1.0,0,1210,570
455000.0,4.0,2.25,2450,1.0,2,1650,800
587206.0,3.0,3.5,1890,2.0,0,1640,250
425000.0,3.0,2.5,2540,2.0,0,2540,0
511500.0,4.0,1.0,1360,1.5,0,1360,0
218000.0,2.0,2.0,1310,2.0,0,1310,0
332000.0,3.0,2.0,1510,1.0,0,1510,0
279000.0,4.0,2.0,2200,1.0,0,1100,1100
950000.0,4.0,2.5,3360,2.0,0,3360,0
970500.0,3.0,2.75,2470,2.0,0,2470,0
412000.0,2.0,1.0,1260,1.0,0,690,570
400000.0,3.0,1.0,1430,1.5,0,1430,0
200000.0,3.0,2.25,1230,1.5,0,1230,0
397000.0,4.0,2.5,2320,2.0,0,2320,0
715000.0,4.0,2.5,3290,2.0,0,3290,0
371000.0,4.0,2.5,2550,2.0,0,2550,0
458000.0,3.0,2.5,1870,2.0,0,1870,0
436500.0,5.0,3.0,3110,1.0,0,1790,1320
329950.0,3.0,2.5,1820,2.0,0,1820,0
950000.0,3.0,3.25,3050,1.0,4,1650,1400
282000.0,4.0,2.0,1890,2.0,0,1890,0
250000.0,1.0,1.0,800,1.0,0,680,120
200000.0,2.0,1.0,860,1.0,0,860,0
1300000.0,5.0,4.0,3366,2.5,2,2966,400
355000.0,4.0,2.5,2040,2.0,0,2040,0
425000.0,3.0,2.25,1790,1.0,0,1290,500
869000.0,4.0,3.0,3740,2.0,0,3060,680
915000.0,3.0,3.25,2660,2.0,0,2170,490
925000.0,4.0,2.0,3140,1.0,0,2040,1100
390000.0,3.0,1.0,1160,1.5,0,1160,0
330000.0,3.0,2.25,1860,2.0,0,1860,0
482500.0,4.0,3.0,1630,1.0,0,1110,520
525000.0,3.0,2.25,1750,3.0,0,1750,0
237000.0,3.0,1.0,1300,1.0,0,1300,0
205000.0,3.0,1.0,960,1.0,0,960,0
623000.0,3.0,2.5,1850,2.0,0,1850,0
565000.0,4.0,2.75,3260,2.0,0,3260,0
400000.0,4.0,2.25,2420,1.0,0,1400,1020
405000.0,3.0,1.0,1460,1.5,0,1460,0
337000.0,4.0,3.0,2240,2.0,0,2240,0
355000.0,2.0,1.0,1240,1.0,1,1000,240
885000.0,3.0,2.25,2060,1.0,0,1610,450
420000.0,5.0,2.75,2280,1.0,0,1300,980
448000.0,4.0,2.5,2510,2.0,2,2510,0
800000.0,4.0,2.75,3150,2.0,0,3150,0
830000.0,5.0,2.25,2780,2.0,0,2780,0
780000.0,3.0,2.25,2140,2.0,0,2140,0
325000.0,2.0,1.0,840,1.0,0,840,0
488800.0,4.0,2.25,2170,1.0,0,1300,870
489000.0,4.0,2.0,2120,1.0,0,1060,1060
595000.0,3.0,2.75,3290,2.0,0,3290,0
359900.0,5.0,2.25,2290,1.0,0,1290,1000
925000.0,4.0,2.75,3730,2.0,0,3730,0
625000.0,3.0,2.5,2440,2.0,0,2440,0
339990.0,3.0,2.5,2570,2.0,0,2570,0
775950.0,4.0,2.5,2970,2.0,0,2970,0
420000.0,5.0,3.0,2630,2.0,0,1670,960
654000.0,3.0,3.25,1530,2.0,0,1280,250
725000.0,3.0,3.5,3690,2.0,0,3690,0
375000.0,2.0,1.0,1230,2.0,0,830,400
1100000.0,3.0,2.5,2200,1.0,1,1400,800
639500.0,4.0,2.25,2330,2.0,0,2330,0
849000.0,4.0,2.0,2160,1.5,1,2160,0
418000.0,4.0,1.5,1550,1.0,0,1000,550
442900.0,4.0,1.75,1780,1.0,0,890,890
750000.0,3.0,1.75,2610,1.5,0,1680,930
930000.0,3.0,2.5,3290,2.0,0,3290,0
565000.0,2.0,1.75,1330,1.0,0,960,370
874150.0,4.0,3.5,3530,2.0,1,2570,960
545000.0,4.0,2.5,2090,2.0,0,2090,0
500000.0,4.0,2.5,2040,1.0,0,1420,620
687000.0,4.0,2.5,2370,2.0,0,2370,0
810000.0,4.0,2.5,2810,2.0,0,2810,0
439500.0,3.0,2.5,2050,1.0,0,1570,480
802000.0,3.0,1.75,2870,1.5,0,1840,1030
732600.0,4.0,2.5,2130,1.0,0,1230,900
374000.0,4.0,2.5,2580,2.0,0,2580,0
330000.0,4.0,2.5,2380,2.0,0,2380,0
290900.0,2.0,2.0,1610,2.0,0,1610,0
577000.0,3.0,2.5,2060,1.0,0,1330,730
280000.0,2.0,1.0,1010,1.0,0,1010,0
675000.0,4.0,2.5,2810,2.0,0,2810,0
800000.0,3.0,2.25,2380,1.0,0,1450,930
299995.0,2.0,1.0,1060,1.0,0,1060,0
440000.0,3.0,1.75,1560,1.0,0,1250,310
249500.0,2.0,1.75,1500,1.0,0,1500,0
690000.0,2.0,1.0,970,1.0,0,970,0
235000.0,3.0,1.0,1170,1.0,0,1170,0
320000.0,3.0,2.5,2280,2.0,0,2280,0
334000.0,4.0,1.5,1150,1.5,0,1150,0
442000.0,4.0,2.5,2520,2.0,0,2520,0
264000.0,3.0,1.75,1760,1.0,0,1760,0
275000.0,2.0,1.0,1180,1.0,0,1180,0
430000.0,2.0,1.5,950,1.0,0,950,0
550000.0,3.0,2.5,1900,2.0,0,1900,0
775000.0,4.0,2.5,2300,2.0,0,2300,0
449000.0,4.0,2.5,1850,1.0,0,1230,620
420000.0,3.0,2.0,1200,1.0,0,880,320
735000.0,4.0,2.25,2270,1.0,0,1340,930
200000.0,3.0,1.5,1090,1.0,0,1090,0
286000.0,3.0,2.75,1100,2.0,0,780,320
579000.0,3.0,2.5,1640,3.0,0,1640,0
345100.0,3.0,3.75,1950,1.0,0,1360,590
350000.0,3.0,1.75,1660,1.5,0,1660,0
291500.0,3.0,1.0,880,1.5,0,880,0
649950.0,3.0,2.5,1500,2.0,0,1200,300
458500.0,3.0,2.0,1890,2.0,0,1430,460
500000.0,3.0,1.0,1150,2.0,0,1150,0
362300.0,3.0,2.5,2430,2.0,0,2430,0
324000.0,4.0,1.75,2110,1.0,0,1170,940
495000.0,3.0,2.0,2950,2.0,0,2310,640
233500.0,3.0,2.25,1650,2.0,0,1650,0
479000.0,3.0,2.25,2110,2.0,0,2110,0
322200.0,4.0,2.25,2010,2.0,0,2010,0
835000.0,4.0,2.5,3030,2.0,0,3030,0
347000.0,3.0,1.0,1270,1.0,0,1270,0
725000.0,3.0,1.75,1610,1.0,0,1610,0
345000.0,3.0,1.0,1140,2.0,0,1140,0
345950.0,3.0,2.5,2110,2.0,0,2110,0
550000.0,3.0,1.75,1840,1.0,0,1840,0
399950.0,3.0,1.75,1560,1.0,0,810,750
269500.0,3.0,1.75,1840,1.0,0,1240,600
494000.0,4.0,2.5,1830,1.0,0,1540,290
453000.0,4.0,1.75,2120,1.0,0,1060,1060
442500.0,3.0,1.75,1600,1.0,0,1050,550
235000.0,4.0,1.75,1450,1.5,0,1180,270
389800.0,3.0,1.75,1880,1.0,0,1880,0
346000.0,3.0,1.75,1270,1.0,0,880,390
360000.0,4.0,1.5,1720,1.0,0,1720,0
650000.0,4.0,2.5,2400,2.0,0,2400,0
290000.0,3.0,1.0,1150,1.0,0,990,160
234000.0,2.0,1.0,870,1.0,0,870,0
260000.0,4.0,2.5,2000,2.0,0,2000,0
349900.0,3.0,2.0,2420,1.0,0,1210,1210
275000.0,3.0,1.0,1080,1.0,0,1080,0
725000.0,4.0,2.5,3420,2.0,0,3420,0
375000.0,4.0,2.5,1870,2.0,0,1870,0
470000.0,3.0,2.5,2150,2.0,0,2150,0
490000.0,3.0,2.25,1470,2.0,0,1080,390
615000.0,5.0,2.0,2130,1.5,0,1270,860
249000.0,3.0,1.0,1000,1.0,0,1000,0
396500.0,3.0,1.75,2390,1.0,0,1350,1040
405000.0,2.0,1.0,860,1.0,0,860,0
560000.0,3.0,2.5,1960,2.0,0,1960,0
459950.0,4.0,2.5,2000,2.0,0,2000,0
265000.0,3.0,1.0,1620,1.5,0,1620,0
430000.0,3.0,1.75,1300,1.0,0,1300,0
525000.0,2.0,1.0,1080,1.0,3,1080,0
415000.0,4.0,2.5,2170,1.0,3,1350,820
600000.0,3.0,2.5,2260,2.0,0,2260,0
225000.0,3.0,1.75,1580,1.0,0,1580,0
300000.0,4.0,2.5,2620,2.0,0,2620,0
491234.0,4.0,2.5,1540,2.0,0,1540,0
905000.0,4.0,3.25,3440,2.0,0,3440,0
199950.0,5.0,2.5,1740,1.0,0,1740,0
450000.0,4.0,1.75,2160,1.0,0,1260,900
899000.0,3.0,1.0,1480,2.0,0,1480,0
400000.0,4.0,1.75,1700,1.5,0,1340,360
471001.0,3.0,1.75,1800,1.0,0,900,900
385000.0,3.0,3.25,1630,3.0,0,1630,0
326000.0,3.0,1.0,1030,1.0,0,1030,0
335000.0,1.0,1.0,720,1.0,0,720,0
320000.0,4.0,1.5,1890,1.0,0,1890,0
300000.0,4.0,2.5,1840,2.0,0,1840,0
269950.0,4.0,2.5,2540,2.0,0,2540,0
1220000.0,4.0,3.75,3520,1.5,0,2200,1320
590000.0,4.0,2.5,3220,1.5,0,3220,0
750000.0,3.0,2.0,1820,1.5,0,1720,100
239950.0,3.0,1.75,1230,1.0,0,1230,0
215000.0,3.0,2.0,1340,1.0,0,1340,0
165000.0,3.0,1.0,1200,1.0,0,1200,0
261350.0,3.0,1.75,1390,1.0,0,1390,0
569000.0,4.0,2.0,1730,1.0,0,1060,670
425000.0,3.0,2.25,1580,1.0,0,1180,400
715000.0,4.0,2.5,2650,1.0,0,1680,970
337000.0,3.0,1.75,1310,1.0,0,1310,0
560000.0,4.0,2.5,2300,2.0,0,2300,0
449500.0,3.0,2.25,1780,1.0,2,1340,440
660000.0,3.0,3.25,1980,3.0,0,1980,0
685000.0,2.0,1.5,1300,1.0,2,1300,0
905000.0,5.0,3.5,3500,2.0,0,2570,930
403500.0,3.0,1.0,1830,1.0,0,1200,630
405000.0,3.0,2.25,1520,3.0,0,1520,0
385000.0,4.0,2.75,2700,2.0,0,2700,0
285000.0,3.0,2.5,1660,2.0,0,1660,0
249900.0,3.0,2.0,1310,1.0,0,1310,0
633634.0,4.0,3.5,2960,2.0,0,2960,0
329900.0,3.0,2.5,2242,2.0,0,2242,0
310000.0,3.0,2.5,2540,2.0,0,2540,0
345000.0,3.0,1.5,1420,2.0,0,1140,280
160797.0,3.0,1.5,1270,2.0,0,1270,0
562500.0,3.0,2.25,1300,2.0,0,1000,300
664950.0,5.0,3.0,3190,1.0,2,1890,1300
515000.0,5.0,3.25,2910,2.0,0,2040,870
497000.0,3.0,2.25,1630,2.0,0,1630,0
312891.0,5.0,3.0,2300,2.0,0,2300,0
670000.0,3.0,2.5,3310,2.0,2,2440,870
362500.0,2.0,1.5,940,2.0,0,940,0
402101.0,2.0,0.75,1020,2.0,0,1020,0
438000.0,3.0,1.75,1520,1.0,0,790,730
687500.0,4.0,1.75,2330,1.5,0,1510,820
160000.0,3.0,1.5,1010,1.0,0,1010,0
415000.0,3.0,1.75,1070,1.0,0,1070,0
405000.0,3.0,2.5,3170,2.0,0,2360,810
880000.0,4.0,2.5,3030,3.0,0,3030,0
640000.0,4.0,2.5,2341,2.0,0,2341,0
819000.0,3.0,3.5,2130,2.0,2,1530,600
520000.0,3.0,1.75,2300,1.0,0,2300,0
367500.0,3.0,1.0,1660,1.0,0,1160,500
762500.0,4.0,2.75,2610,1.0,0,1760,850
300000.0,3.0,1.0,2150,1.0,0,2150,0
530000.0,2.0,1.5,1580,1.0,2,1280,300
379000.0,3.0,2.5,1740,2.0,0,1740,0
615000.0,2.0,1.0,1270,1.0,0,1090,180
660000.0,2.0,2.25,2550,2.0,0,1860,690
380000.0,3.0,2.25,1860,2.0,0,1860,0
314900.0,4.0,1.75,2700,1.0,0,1380,1320
324950.0,3.0,1.5,1460,1.0,0,1460,0
225000.0,3.0,1.75,1330,1.0,0,1330,0
535000.0,3.0,2.5,2070,2.0,0,2070,0
348500.0,3.0,1.5,1360,1.0,0,1360,0
725000.0,4.0,2.5,2650,2.0,0,2650,0
925000.0,4.0,3.0,3580,1.5,0,3580,0
549000.0,2.0,1.0,2034,1.0,4,1159,875
400000.0,3.0,2.0,1230,1.0,0,990,240
1157400.0,3.0,2.5,2740,2.0,2,2740,0
349950.0,4.0,2.5,2090,2.0,0,2090,0
339000.0,4.0,2.0,2470,1.5,0,1970,500
615000.0,3.0,1.75,1720,1.0,0,960,760
751000.0,4.0,3.25,3090,2.0,0,2370,720
941000.0,4.0,1.75,2320,1.5,0,1820,500
600000.0,4.0,1.75,1740,1.0,0,1740,0
455000.0,4.0,2.5,2950,2.0,0,2950,0
485000.0,3.0,2.5,1500,1.0,0,900,600
339000.0,3.0,1.0,1100,1.0,0,720,380
258000.0,3.0,1.0,1490,1.0,0,1120,370
455000.0,2.0,1.5,1200,2.0,0,1000,200
437000.0,4.0,2.5,1890,1.0,0,1290,600
689000.0,3.0,1.75,2200,1.0,0,1500,700
319000.0,4.0,2.5,2510,1.0,0,1610,900
510000.0,3.0,2.25,1420,3.0,0,1420,0
440000.0,3.0,1.75,2000,1.0,2,1480,520
1010000.0,2.0,2.0,1460,1.0,2,1460,0
875000.0,4.0,2.5,3220,2.0,0,3220,0
304000.0,4.0,2.0,1310,1.0,0,1310,0
139000.0,2.0,1.0,690,1.0,0,690,0
464500.0,3.0,1.75,1150,1.0,0,1150,0
336500.0,3.0,1.0,1480,1.0,0,970,510
230000.0,4.0,1.75,1850,1.0,0,1270,580
425000.0,3.0,2.5,1930,2.0,0,1930,0
300000.0,2.0,1.0,750,1.0,0,750,0
457500.0,3.0,2.25,1430,2.0,0,980,450
366000.0,3.0,1.75,1840,1.0,0,1340,500
502000.0,3.0,2.0,1300,1.0,0,1300,0
194000.0,3.0,1.0,1050,1.0,0,1050,0
305000.0,4.0,2.25,2210,2.0,0,2210,0
343500.0,4.0,1.75,1760,1.0,2,1180,580
325000.0,3.0,1.0,850,1.0,0,850,0
850000.0,4.0,3.5,3920,2.0,0,3920,0
420000.0,3.0,2.5,2140,2.0,0,2140,0
257500.0,2.0,2.0,1180,1.0,0,1180,0
317000.0,5.0,2.5,2360,1.0,0,1180,1180
970000.0,3.0,2.25,3060,1.5,2,1810,1250
252000.0,3.0,2.25,1670,1.0,0,1190,480
683500.0,3.0,1.5,1820,1.5,0,1640,180
289000.0,3.0,2.5,1970,2.0,0,1090,880
355000.0,2.0,2.25,930,2.0,0,630,300
675000.0,3.0,3.5,2300,1.0,0,2300,0
396500.0,3.0,2.5,2590,1.0,0,2590,0
362500.0,4.0,1.75,1450,1.0,0,1450,0
395000.0,4.0,1.75,1540,1.0,0,770,770
599000.0,5.0,2.75,2730,1.0,0,2080,650
218000.0,3.0,1.0,880,1.0,0,880,0
589950.0,4.0,2.5,3190,2.0,0,3190,0
218000.0,3.0,1.5,1330,1.0,0,1330,0
360000.0,3.0,1.75,1500,1.0,0,1500,0
350000.0,2.0,1.0,740,1.0,0,740,0
350000.0,4.0,3.0,2560,2.0,0,2560,0
845000.0,3.0,2.0,2540,1.5,0,1840,700
329950.0,2.0,1.0,900,1.0,0,900,0
425000.0,4.0,1.5,1600,1.5,0,1600,0
210000.0,2.0,1.0,970,1.0,0,970,0
631500.0,2.0,1.0,1130,1.0,0,1130,0
295000.0,2.0,1.0,650,1.0,0,650,0
575000.0,3.0,2.25,2400,1.5,0,1440,960
415000.0,3.0,2.5,2280,2.0,0,2280,0
639888.0,4.0,2.5,2050,2.0,0,2050,0
329445.0,2.0,1.5,830,2.0,0,830,0
745641.0,4.0,2.5,2440,2.0,0,2440,0
395000.0,3.0,2.5,1600,2.0,0,1600,0
790000.0,4.0,3.5,3190,2.0,0,3190,0
890000.0,4.0,1.0,2550,2.0,0,2370,180
400000.0,3.0,2.5,2180,1.0,0,1420,760
365500.0,3.0,2.0,1410,1.0,0,1410,0
245000.0,3.0,2.0,1410,1.0,0,1410,0
390000.0,4.0,2.5,2340,2.0,0,2340,0
196500.0,3.0,1.0,1320,1.0,0,1320,0
276900.0,3.0,1.0,1270,1.0,0,1270,0
505000.0,3.0,2.5,1860,2.0,0,1860,0
1229000.0,4.0,3.5,3770,2.0,0,2830,940
352000.0,4.0,1.0,1530,1.0,0,980,550
597326.0,4.0,4.0,3570,2.0,0,2860,710
800000.0,2.0,1.0,1740,1.0,0,1740,0
270000.0,3.0,2.5,1670,1.0,0,1300,370
235000.0,4.0,2.0,1570,2.0,0,1570,0
409900.0,2.0,2.5,1590,2.0,0,1590,0
739900.0,5.0,2.5,2980,2.0,0,2980,0
608000.0,4.0,2.5,2690,2.0,0,2690,0
381500.0,2.0,1.0,900,1.0,0,900,0
562100.0,2.0,0.75,1440,1.0,0,1200,240
740000.0,4.0,2.5,3000,2.0,0,3000,0
308000.0,3.0,1.0,1640,1.5,0,1640,0
905000.0,5.0,3.5,3100,1.0,4,1660,1440
356000.0,4.0,2.0,2020,1.5,0,2020,0
750000.0,3.0,1.5,1840,1.5,0,1340,500
418800.0,4.0,2.25,2100,1.0,0,1290,810
276000.0,4.0,2.25,2460,1.0,0,2460,0
725000.0,3.0,2.5,2610,2.0,0,2610,0
285000.0,3.0,2.0,1460,1.0,0,1460,0
205000.0,3.0,1.0,1050,1.0,0,1050,0
583000.0,3.0,2.5,1790,2.0,0,1790,0
657000.0,4.0,2.5,2180,1.5,0,1420,760
386000.0,4.0,2.25,2050,2.0,2,1770,280
589950.0,5.0,3.0,2790,1.0,3,1500,1290
575000.0,3.0,2.25,1700,1.5,0,1100,600
574000.0,3.0,2.5,2380,2.0,0,2380,0
690500.0,5.0,2.0,2000,1.5,2,1280,720
565000.0,2.0,1.75,1670,1.0,0,1670,0
500000.0,3.0,1.5,1190,1.0,0,970,220
286000.0,2.0,1.0,780,1.0,0,780,0
450000.0,3.0,1.5,2330,1.0,0,1330,1000
870000.0,4.0,2.75,2840,1.5,0,1960,880
725000.0,4.0,2.5,2490,2.0,0,2490,0
275000.0,2.0,1.0,770,1.0,0,770,0
645000.0,3.0,2.75,1850,1.0,2,1850,0
152000.0,3.0,1.0,1090,1.0,0,1090,0
315000.0,4.0,2.0,1780,1.5,0,930,850
190000.0,1.0,0.75,930,1.0,0,930,0
700000.0,4.0,2.5,2770,2.0,0,2770,0
233000.0,3.0,1.0,1250,1.5,0,1250,0
249000.0,4.0,2.25,1830,2.0,0,1830,0
310000.0,2.0,1.0,870,1.0,0,870,0
265950.0,3.0,1.5,1150,1.0,0,1150,0
200000.0,3.0,1.0,1150,1.5,0,1150,0
402000.0,4.0,2.25,2000,2.0,0,1650,350
505000.0,3.0,1.75,1640,1.0,2,1640,0
482000.0,3.0,2.5,2420,2.0,0,2420,0
299950.0,3.0,1.75,1790,1.0,3,1790,0
770000.0,4.0,2.5,3920,2.0,0,3920,0
245700.0,3.0,2.25,1640,1.0,0,1180,460
283000.0,3.0,1.0,890,1.0,0,890,0
650000.0,4.0,2.75,1910,1.0,0,1420,490
530000.0,5.0,2.25,2140,1.0,0,1070,1070
440000.0,3.0,1.75,2030,1.0,0,2030,0
599990.0,3.0,2.25,2680,1.0,0,1570,1110
544000.0,4.0,2.5,2030,2.0,0,2030,0
270000.0,2.0,1.0,2060,1.0,0,1260,800
435000.0,2.0,1.0,1060,1.5,0,1060,0
349000.0,3.0,1.0,1010,1.0,0,1010,0
320000.0,4.0,2.5,2000,2.0,0,2000,0
804100.0,4.0,2.5,3070,2.0,0,3070,0
594000.0,3.0,2.25,1270,2.0,0,1060,210
1150000.0,3.0,2.0,2110,2.0,0,2110,0
374500.0,3.0,2.25,1400,2.0,0,1400,0
450000.0,4.0,2.75,2310,1.0,2,1330,980
744500.0,5.0,2.5,2700,1.0,0,1750,950
913888.0,5.0,2.25,2370,2.0,0,2370,0
760000.0,4.0,2.5,2760,2.0,0,2230,530
346500.0,2.0,1.75,1610,1.0,0,1010,600
280000.0,3.0,1.75,1230,1.0,0,1230,0
557500.0,3.0,1.75,1900,1.0,0,1900,0
260000.0,3.0,1.5,1580,1.0,0,1140,440
1330000.0,3.0,1.5,1940,1.5,2,1940,0
640000.0,3.0,1.75,1620,1.0,0,1040,580
205000.0,3.0,1.0,1230,1.0,0,1230,0
957000.0,5.0,3.25,3160,2.0,2,2180,980
625000.0,5.0,2.5,2700,1.0,0,1950,750
680000.0,4.0,1.5,1880,1.0,2,1440,440
150000.0,2.0,1.0,890,1.0,0,890,0
255950.0,3.0,2.5,1720,2.0,0,1720,0
246500.0,3.0,2.5,1620,2.0,0,1620,0
450000.0,2.0,1.0,1380,1.0,0,880,500
595888.0,3.0,1.75,1870,1.0,0,1870,0
454000.0,3.0,1.0,1970,1.0,0,1970,0
299900.0,3.0,1.0,1110,1.0,0,1110,0
200000.0,3.0,2.0,1190,1.0,0,1190,0
346500.0,3.0,1.0,1150,1.0,0,1150,0
585000.0,4.0,2.75,2890,1.0,0,1560,1330
383000.0,3.0,1.75,1500,1.0,0,1500,0
519000.0,4.0,2.5,1950,1.5,0,1250,700
410000.0,3.0,1.5,1250,1.0,0,1250,0
578000.0,4.0,2.5,2070,2.0,0,2070,0
395000.0,2.0,2.25,1350,2.0,0,1050,300
364000.0,3.0,2.5,1800,2.0,0,1800,0
240000.0,3.0,2.25,1481,2.0,0,1481,0
328423.0,3.0,2.5,1730,2.0,0,1730,0
594000.0,4.0,2.75,2720,2.0,0,2720,0
425000.0,3.0,2.5,2320,3.0,0,2320,0
309620.0,3.0,2.5,1860,2.0,0,1860,0
260000.0,5.0,2.5,2025,2.0,0,2025,0
975000.0,5.0,3.0,2620,2.0,0,2620,0
937000.0,3.0,1.75,2450,2.0,0,1750,700
518500.0,3.0,3.5,1590,3.0,0,1590,0
1050000.0,4.0,3.5,3450,2.0,0,3450,0
350000.0,3.0,2.25,1780,2.0,0,1780,0
826000.0,4.0,2.5,3060,2.0,0,3060,0
225000.0,3.0,2.0,1700,1.0,0,970,730
235867.0,4.0,2.0,1330,1.0,0,1330,0
399000.0,4.0,3.0,3060,2.0,0,3060,0
177500.0,3.0,1.5,1220,1.0,0,1220,0
224000.0,4.0,1.5,1600,1.0,0,1600,0
302000.0,4.0,1.75,1530,1.5,0,1530,0
760000.0,3.0,2.5,1980,1.0,0,1980,0
460000.0,3.0,2.5,1730,1.0,0,1210,520
415000.0,3.0,1.0,1170,1.0,0,1170,0
669000.0,2.0,1.75,1950,1.0,3,1160,790
254600.0,3.0,2.0,1470,1.0,0,1470,0
357250.0,3.0,1.5,1400,1.0,0,1400,0
670000.0,3.0,1.5,1490,1.5,0,1490,0
440000.0,4.0,1.5,1770,2.0,0,1770,0
1025000.0,4.0,3.5,3320,1.0,2,2040,1280
320000.0,2.0,1.0,950,1.0,2,950,0
310000.0,4.0,2.5,2430,2.0,0,2430,0
772650.0,4.0,2.5,2660,1.0,0,2660,0
669950.0,4.0,2.5,2670,2.0,0,2670,0
690000.0,5.0,3.5,2720,2.0,0,1860,860
663000.0,3.0,2.5,2480,1.5,3,2480,0
300000.0,3.0,2.25,1780,1.0,0,1780,0
225500.0,2.0,1.75,1590,1.0,0,1590,0
320000.0,3.0,2.0,1550,1.5,0,1550,0
775000.0,3.0,2.75,2850,1.0,0,1920,930
805000.0,3.0,2.75,2600,1.5,2,1600,1000
252750.0,4.0,1.0,1230,1.5,0,1230,0
254000.0,5.0,2.0,2080,1.0,0,1740,340
435000.0,4.0,2.75,2110,1.0,0,1510,600
460000.0,4.0,2.5,2550,1.0,0,1300,1250
268000.0,3.0,2.5,1650,2.0,0,1650,0
446000.0,2.0,1.5,1370,2.0,0,1080,290
285000.0,2.0,1.0,1010,1.0,0,1010,0
530000.0,3.0,2.0,2330,2.5,0,2330,0
402000.0,2.0,1.0,620,1.0,0,620,0
358000.0,3.0,1.5,2450,1.0,0,2450,0
354950.0,4.0,2.75,2530,1.0,0,1280,1250
405000.0,4.0,2.5,2220,2.0,0,2220,0
315000.0,4.0,2.5,1940,1.0,0,1140,800
280927.0,4.0,2.25,2070,2.0,0,2070,0
440000.0,4.0,2.5,2160,1.0,0,1390,770
270000.0,4.0,2.25,2600,1.0,0,1600,1000
755000.0,4.0,2.75,2880,1.5,0,2100,780
289659.0,4.0,2.25,2260,2.0,0,2260,0
555000.0,5.0,3.0,3640,2.0,0,3640,0
450000.0,3.0,1.5,1530,1.0,0,1530,0
1145000.0,3.0,2.5,2490,2.0,0,1670,820
495000.0,3.0,1.75,1440,1.0,0,1440,0
1250000.0,3.0,3.0,3760,2.5,3,3060,700
580000.0,4.0,1.75,1720,1.0,0,1420,300
560000.0,4.0,2.5,2480,1.0,0,1510,970
450000.0,2.0,1.75,840,1.0,0,700,140
815000.0,3.0,2.0,2270,1.0,0,2270,0
354000.0,4.0,2.5,2580,2.0,0,2580,0
279900.0,3.0,1.75,1580,1.0,0,1580,0
339000.0,2.0,1.0,950,1.0,0,950,0
1340000.0,4.0,3.5,3190,2.0,3,2160,1030
815000.0,4.0,2.75,2620,1.0,2,1310,1310
638000.0,3.0,2.0,1660,1.0,0,970,690
475580.0,3.0,1.75,1520,1.0,0,1520,0
243800.0,3.0,1.0,1140,1.0,0,1140,0
600000.0,3.0,2.5,3240,2.0,0,2910,330
620000.0,3.0,2.0,2460,1.0,0,2460,0
750000.0,4.0,2.75,1750,1.5,0,1750,0
626000.0,3.0,1.75,2430,2.0,0,1760,670
230000.0,3.0,1.0,1060,1.0,0,1060,0
537000.0,3.0,3.0,2410,2.0,2,2410,0
210000.0,2.0,1.0,720,1.0,0,720,0
200500.0,3.0,1.75,1260,1.0,0,1260,0
253500.0,3.0,1.0,1640,1.0,0,1090,550
150000.0,3.0,1.0,1310,1.0,0,960,350
440000.0,3.0,1.5,2120,1.0,0,1220,900
660000.0,3.0,1.0,1210,1.0,1,1210,0
695000.0,3.0,2.75,2590,2.0,0,2590,0
440000.0,4.0,2.5,2250,2.0,0,2250,0
219500.0,3.0,1.0,1090,1.5,0,1090,0
220000.0,3.0,1.5,1660,2.0,0,1660,0
900000.0,4.0,3.5,3370,2.0,2,2470,900
800000.0,4.0,2.5,2990,2.0,0,2990,0
365000.0,5.0,2.0,2280,1.5,0,2280,0
451000.0,5.0,2.75,2830,1.5,0,2830,0
202000.0,2.0,1.0,920,1.0,0,920,0
471000.0,2.0,1.75,1240,1.0,0,1240,0
827000.0,4.0,2.5,3230,1.0,0,1870,1360
235000.0,5.0,2.5,2500,1.0,0,1300,1200
216500.0,2.0,1.75,1390,1.0,0,1390,0
359000.0,5.0,1.75,1940,1.5,0,1940,0
252500.0,3.0,2.0,1900,1.0,0,1900,0
370000.0,3.0,1.5,2380,1.0,0,1850,530
663000.0,3.0,2.0,1480,1.0,0,860,620
971971.0,4.0,3.75,3460,2.0,0,3460,0
330675.0,4.0,3.0,1930,1.0,0,1200,730
240000.0,4.0,1.0,1200,1.5,0,1200,0
334888.0,3.0,2.5,1769,2.0,0,1769,0
414000.0,3.0,2.5,2490,2.5,0,2490,0
782900.0,4.0,3.25,3060,2.0,0,2300,760
525000.0,4.0,2.75,3030,2.0,0,3030,0
429900.0,3.0,2.5,2370,2.0,0,2370,0
390000.0,3.0,3.25,1370,2.0,0,1100,270
224000.0,3.0,1.75,1500,1.0,0,1500,0
257500.0,3.0,2.25,1715,2.0,0,1715,0
665000.0,2.0,1.0,1110,1.0,0,1110,0
327000.0,5.0,2.75,2400,2.0,0,2400,0
687500.0,4.0,2.75,3190,2.0,0,3190,0
672500.0,3.0,2.25,2400,1.5,0,1250,1150
140000.0,3.0,1.0,1060,1.0,0,1060,0
215500.0,2.0,1.75,1220,1.0,0,1220,0
464900.0,4.0,2.25,2020,1.0,0,1380,640
417000.0,4.0,2.25,2300,1.0,0,1380,920
453000.0,4.0,2.75,2300,1.0,3,1550,750
700000.0,3.0,2.5,1660,2.0,2,1400,260
259500.0,3.0,1.75,1650,1.0,0,1650,0
460000.0,4.0,2.5,2110,1.0,0,1290,820
561500.0,3.0,1.75,1960,1.0,0,980,980
330000.0,4.0,1.75,2440,1.0,0,1610,830
447000.0,2.0,1.0,1320,1.0,0,1320,0
320000.0,4.0,2.5,2570,2.0,0,2570,0
212700.0,2.0,1.0,940,1.0,0,940,0
260000.0,2.0,1.0,700,1.0,0,700,0
410000.0,3.0,2.0,1400,2.0,0,1400,0
355000.0,4.0,2.5,1890,2.0,0,1890,0
275500.0,2.0,1.0,720,1.0,0,720,0
415000.0,3.0,1.75,2410,1.0,0,1860,550
279000.0,3.0,2.5,1630,1.0,0,1320,310
350000.0,5.0,1.75,2330,1.0,0,1180,1150
355000.0,2.0,2.25,1330,2.0,0,1330,0
750000.0,4.0,2.25,3190,2.0,0,2300,890
235000.0,3.0,1.75,1400,1.0,0,1400,0
209950.0,3.0,1.0,970,1.0,0,970,0
230000.0,3.0,1.75,1010,1.0,0,1010,0
430000.0,2.0,1.0,1050,1.0,0,850,200
661500.0,5.0,2.5,2500,1.0,0,1490,1010
738000.0,3.0,3.0,2630,2.0,0,2630,0
221000.0,3.0,1.0,910,1.0,0,910,0
665000.0,3.0,2.5,2610,2.0,0,2610,0
255000.0,3.0,2.5,1720,2.0,0,1720,0
1195000.0,5.0,2.75,3650,2.0,0,2750,900
355000.0,3.0,1.75,2040,1.0,0,2040,0
755000.0,5.0,2.5,3260,1.5,1,2310,950
300000.0,3.0,1.5,1590,1.0,0,1590,0
500000.0,4.0,1.0,1440,1.5,0,1440,0
191000.0,2.0,1.0,900,1.0,0,900,0
415000.0,3.0,2.5,1060,2.0,0,1060,0
394000.0,4.0,2.5,3000,2.0,0,3000,0
490000.0,3.0,2.5,2230,2.0,0,2230,0
523460.0,5.0,1.75,1890,1.5,0,1090,800
342000.0,3.0,1.75,1780,1.0,0,1280,500
560000.0,4.0,2.5,2710,2.0,0,2710,0
710000.0,2.0,1.5,1640,1.5,0,1540,100
1020000.0,3.0,2.25,1670,1.5,3,1670,0
399950.0,3.0,2.5,2570,2.0,0,2570,0
480000.0,2.0,1.0,1500,1.0,0,1500,0
410000.0,3.0,1.0,2710,2.0,3,2710,0
530000.0,4.0,1.75,2860,1.0,0,1710,1150
528000.0,2.0,0.75,840,1.0,4,840,0
469900.0,4.0,2.5,2990,2.0,0,2990,0
397000.0,5.0,1.0,1170,1.0,0,800,370
718500.0,3.0,1.5,1200,1.0,0,1030,170
195000.0,2.0,1.0,1020,1.0,0,1020,0
285000.0,2.0,1.0,910,1.0,0,910,0
295000.0,1.0,1.0,700,1.0,0,700,0
602000.0,4.0,1.75,2420,1.0,0,1880,540
235000.0,3.0,1.75,1950,1.0,0,1950,0
465000.0,4.0,2.5,3060,2.0,0,3060,0
234000.0,4.0,1.0,1390,1.0,0,1390,0
504200.0,2.0,1.5,1200,3.0,0,1200,0
710000.0,3.0,2.5,2440,2.0,0,2440,0
589500.0,3.0,3.25,2310,2.0,0,1730,580
735000.0,3.0,2.25,1490,2.0,0,1040,450
427000.0,3.0,2.5,2432,2.0,2,2432,0
982000.0,4.0,2.75,3610,2.0,0,3610,0
459000.0,4.0,3.0,2530,2.0,0,2530,0
483453.0,4.0,2.75,2790,2.0,0,2790,0
246950.0,3.0,3.0,1670,1.0,0,1670,0
235000.0,1.0,1.5,1170,2.0,0,1070,100
288790.0,4.0,2.0,1350,3.0,0,1350,0
229800.0,2.0,1.75,1110,2.0,0,1110,0
516500.0,1.0,1.25,1100,3.0,0,1100,0
234000.0,3.0,1.0,1040,1.0,0,1040,0
230000.0,2.0,1.75,1910,2.0,0,1910,0
300000.0,4.0,1.0,1370,1.0,0,1370,0
470000.0,3.0,1.5,1500,1.5,0,1140,360
339900.0,3.0,1.0,1200,1.0,0,1200,0
650000.0,2.0,1.0,1050,1.0,0,880,170
585000.0,5.0,2.5,2670,1.5,0,1620,1050
699900.0,4.0,2.5,2190,1.0,0,1430,760
598000.0,4.0,2.5,3130,2.0,0,3130,0
475000.0,3.0,2.5,1700,1.0,0,1160,540
314500.0,3.0,1.75,1700,1.0,0,1200,500
397000.0,3.0,3.5,1360,2.0,0,1240,120
345000.0,3.0,2.0,1610,1.0,0,1610,0
325000.0,5.0,2.75,2130,1.0,0,1300,830
265000.0,3.0,1.0,1800,1.0,0,1800,0
402000.0,4.0,2.75,2950,1.0,0,2120,830
780000.0,4.0,2.5,3500,2.0,0,3500,0
250000.0,3.0,2.0,1440,1.0,0,1440,0
1200000.0,4.0,2.0,2120,2.0,0,2120,0
935000.0,2.0,2.5,1780,2.0,0,1780,0
300000.0,2.0,1.0,960,1.0,0,960,0
419000.0,2.0,1.75,1510,1.0,0,1510,0
410000.0,1.0,1.5,1010,1.0,0,1010,0
1165000.0,3.0,3.0,3790,2.0,0,2810,980
461000.0,3.0,1.75,3600,2.0,0,2400,1200
385000.0,3.0,1.75,1300,1.0,0,1300,0
669500.0,4.0,2.25,2500,1.5,0,1520,980
491950.0,3.0,2.25,2090,1.0,0,1440,650
1230000.0,3.0,1.75,2200,1.5,1,2200,0
560000.0,3.0,2.25,2070,1.5,0,2070,0
370000.0,3.0,1.0,1320,1.0,0,1320,0
100000.0,2.0,1.0,930,1.0,0,930,0
289950.0,3.0,2.5,1760,1.5,0,1760,0
263000.0,3.0,1.75,1410,2.0,0,1410,0
397500.0,4.0,2.5,2570,2.0,0,2570,0
245000.0,3.0,2.75,1300,1.0,0,860,440
535000.0,3.0,1.0,1580,1.0,0,1180,400
449000.0,4.0,2.5,2960,2.0,0,2960,0
490000.0,4.0,3.0,2330,2.0,0,1920,410
445800.0,4.0,2.25,2070,1.0,0,1470,600
345000.0,2.0,1.0,970,1.0,0,970,0
327500.0,3.0,2.25,2310,2.0,0,2310,0
436500.0,4.0,2.5,2290,2.0,0,2290,0
550000.0,3.0,2.25,1720,1.0,0,1220,500
441000.0,2.0,1.5,1190,1.0,0,990,200
406500.0,2.0,1.0,870,1.0,0,870,0
243000.0,2.0,1.5,1068,2.0,0,1068,0
359500.0,4.0,2.75,2140,2.0,0,2140,0
408000.0,5.0,3.25,2820,1.5,0,2320,500
480000.0,4.0,3.0,2440,2.0,0,1890,550
875000.0,4.0,1.5,1800,1.5,0,1800,0
308000.0,3.0,1.0,1010,1.0,0,1010,0
880000.0,4.0,2.75,3220,1.5,0,2320,900
170000.0,2.0,1.0,1200,2.0,0,1200,0
491500.0,3.0,2.25,1470,2.0,0,1470,0
515000.0,3.0,2.5,2600,2.0,0,2600,0
255000.0,2.0,1.0,1320,1.0,0,940,380
635000.0,3.0,2.5,3350,2.0,0,2550,800
850000.0,3.0,2.5,2650,2.0,0,1830,820
265000.0,2.0,2.0,1860,1.0,0,1260,600
349810.0,3.0,1.0,960,1.0,0,960,0
972000.0,4.0,1.75,2010,1.0,2,1610,400
330000.0,4.0,2.5,2340,2.0,0,2340,0
500000.0,4.0,3.0,3720,3.0,0,3720,0
570000.0,3.0,2.0,1890,1.0,0,1470,420
1309500.0,4.0,2.5,2680,1.0,4,1590,1090
544000.0,3.0,2.5,1460,2.0,0,1180,280
439000.0,3.0,2.5,3180,1.0,0,1810,1370
530000.0,4.0,2.25,1980,2.0,0,1980,0
427500.0,2.0,2.0,1090,3.0,0,1090,0
337000.0,4.0,2.5,2230,2.0,0,2230,0
1095000.0,4.0,2.75,3330,2.0,0,3330,0
435000.0,4.0,2.0,1880,1.0,0,970,910
765000.0,5.0,3.0,2870,1.0,0,1950,920
492650.0,4.0,1.75,2120,1.0,0,1640,480
383962.0,4.0,2.5,2700,2.0,0,2700,0
950000.0,4.0,2.5,3670,2.5,0,3670,0
457000.0,3.0,2.5,1220,2.0,0,1010,210
882566.0,4.0,2.5,3560,3.0,0,3560,0
963000.0,4.0,3.25,3530,2.0,0,3530,0
345000.0,4.0,2.5,2280,2.0,0,2280,0
314500.0,3.0,2.0,2050,1.0,0,2050,0
530000.0,3.0,2.5,3660,2.0,2,3260,400
650000.0,4.0,2.5,3350,2.0,0,3350,0
349500.0,3.0,2.0,1270,1.0,0,1270,0
1198000.0,4.0,3.5,3400,2.5,0,2790,610
165050.0,3.0,1.0,1200,1.0,0,1200,0
580000.0,3.0,2.5,2200,2.0,2,2200,0
330000.0,3.0,2.5,1680,1.0,0,1080,600
875000.0,5.0,3.5,3840,2.0,0,3840,0
500000.0,2.0,1.0,950,1.0,2,850,100
445000.0,4.0,2.5,2280,2.0,0,2280,0
274900.0,4.0,2.5,1970,2.0,0,1970,0
219950.0,3.0,1.5,1620,1.0,0,1620,0
691500.0,4.0,2.5,2600,2.0,0,2600,0
459500.0,2.0,1.0,1250,1.0,0,850,400
955500.0,4.0,1.75,2130,1.5,0,2130,0
328950.0,4.0,1.75,2550,1.0,0,1300,1250
307000.0,3.0,1.0,1150,1.5,0,1150,0
382500.0,3.0,1.75,1040,1.0,0,1040,0
1150000.0,4.0,2.5,3340,2.0,0,3340,0
478000.0,3.0,2.25,1640,2.0,0,1640,0
260000.0,2.0,1.0,770,1.0,0,770,0
616000.0,4.0,1.75,1700,1.0,0,1700,0
540000.0,3.0,1.75,2050,1.0,0,1400,650
300000.0,3.0,2.25,1660,2.0,0,1660,0
507500.0,3.0,1.75,1990,1.0,0,1190,800
241000.0,3.0,2.0,1770,1.0,0,1770,0
485000.0,3.0,2.25,2440,2.0,0,2090,350
548000.0,4.0,2.5,2440,2.0,0,2440,0
345000.0,2.0,1.0,1080,1.0,0,1080,0
280000.0,3.0,1.0,1090,1.0,0,1090,0
450000.0,3.0,1.75,1400,1.0,0,1400,0
515000.0,3.0,2.5,2010,2.0,0,2010,0
1014250.0,3.0,1.0,1640,1.5,0,1500,140
739900.0,5.0,2.5,3290,2.0,0,3290,0
600000.0,2.0,2.5,2510,2.0,0,2510,0
370000.0,2.0,1.0,860,1.0,0,860,0
729032.0,4.0,2.5,2840,1.0,0,1780,1060
510000.0,3.0,1.75,1750,2.0,0,1750,0
425000.0,3.0,1.5,1300,1.0,0,1300,0
1080000.0,3.0,2.75,3890,2.0,1,3260,630
337000.0,3.0,2.25,1460,3.0,0,1460,0
563000.0,4.0,1.0,1410,1.5,0,1410,0
245000.0,3.0,2.0,1190,1.5,0,1190,0
590000.0,3.0,2.0,1410,1.0,0,910,500
695000.0,3.0,2.0,2500,1.5,0,1680,820
402500.0,2.0,1.0,800,1.0,0,800,0
435000.0,3.0,2.5,2530,2.0,0,2530,0
660000.0,3.0,2.0,2570,1.0,0,1970,600
300000.0,3.0,2.75,2090,1.0,0,1340,750
600000.0,5.0,2.25,2980,1.0,0,1580,1400
205000.0,3.0,1.75,1170,1.0,0,1170,0
357500.0,3.0,3.5,2080,2.0,0,2080,0
1110000.0,5.0,3.25,3350,2.0,0,2510,840
332888.0,2.0,2.5,1050,2.0,0,950,100
174000.0,2.0,1.0,900,1.0,0,900,0
515000.0,2.0,1.0,1050,1.0,0,1050,0
392000.0,5.0,2.25,3740,1.5,0,2240,1500
485000.0,4.0,1.75,1430,2.0,0,1430,0
217500.0,3.0,1.75,1400,1.0,0,1400,0
502000.0,3.0,2.25,1600,2.0,0,1600,0
820000.0,3.0,2.25,2880,2.0,0,2880,0
102500.0,2.0,1.0,820,1.0,0,820,0
540000.0,4.0,2.5,2180,1.0,0,1180,1000
600000.0,2.0,1.0,910,1.5,0,910,0
406000.0,4.0,1.0,1580,1.5,2,1580,0
620000.0,4.0,3.0,2130,1.0,0,1440,690
401000.0,3.0,2.0,1240,1.0,0,1000,240
725000.0,3.0,1.75,1860,2.0,2,1860,0
276000.0,1.0,0.75,370,1.0,0,370,0
500000.0,5.0,3.25,3130,2.0,0,2180,950
375000.0,3.0,1.75,2530,1.0,0,1800,730
260000.0,3.0,2.25,1920,1.0,0,1300,620
431000.0,4.0,2.5,2300,2.0,0,2300,0
321000.0,4.0,2.5,1830,2.0,0,1830,0
433000.0,4.0,1.5,1550,1.0,0,1180,370
482000.0,3.0,2.25,1710,2.0,0,1710,0
712000.0,3.0,2.5,2375,2.0,0,2375,0
505000.0,4.0,2.75,2200,1.0,0,1100,1100
452000.0,3.0,1.75,1110,1.0,0,1110,0
581000.0,4.0,1.0,1630,1.5,0,1630,0
952500.0,4.0,1.5,2550,2.0,0,2550,0
808000.0,4.0,2.25,2500,2.0,0,2500,0
476000.0,4.0,3.0,2890,1.0,0,1590,1300
535000.0,4.0,1.75,1420,1.5,0,1420,0
629800.0,3.0,2.5,2390,2.0,0,2220,170
417838.0,4.0,2.5,2530,2.0,0,2530,0
399895.0,4.0,2.5,2701,2.0,0,2701,0
300000.0,4.0,2.5,2303,2.0,0,2303,0
640000.0,2.0,2.25,1540,3.0,0,1540,0
460000.0,3.0,2.5,1450,2.0,0,940,510
525000.0,2.0,2.5,1160,2.0,0,1040,120
499990.0,4.0,2.75,2910,2.0,0,2910,0
1020000.0,4.0,3.5,3770,2.0,0,3770,0
675000.0,5.0,2.25,2900,1.0,0,1450,1450
512031.0,3.0,1.75,1540,1.0,2,770,770
310000.0,2.0,1.0,700,1.0,0,700,0
255000.0,4.0,2.0,2430,1.0,0,1430,1000
435000.0,3.0,2.5,1900,2.0,0,1900,0
453000.0,3.0,2.0,1660,1.0,0,1260,400
260000.0,4.0,2.0,1620,2.0,0,1620,0
659000.0,4.0,2.0,2090,1.0,0,2090,0
223000.0,3.0,2.0,1110,1.0,0,1110,0
851000.0,5.0,3.25,3760,2.0,0,2550,1210
605000.0,3.0,2.25,2080,1.0,0,1530,550
895000.0,4.0,2.25,1950,1.0,0,1330,620
519000.0,5.0,2.25,2570,1.0,1,1470,1100
535000.0,3.0,1.75,2330,1.0,0,1390,940
489000.0,3.0,3.0,3700,2.0,0,3700,0
250000.0,3.0,2.25,1920,1.0,0,1520,400
580000.0,3.0,2.25,1900,1.5,0,1200,700
1038000.0,4.0,1.75,1440,1.0,0,1440,0
599950.0,4.0,3.5,2500,2.0,0,1810,690
700000.0,3.0,2.5,2490,2.0,0,2490,0
480000.0,3.0,2.0,1470,1.0,0,1470,0
329950.0,4.0,2.5,2120,2.0,0,2120,0
250000.0,3.0,1.75,1200,1.0,0,1200,0
345000.0,5.0,2.5,2450,2.0,0,2450,0
175000.0,4.0,2.5,1780,2.0,0,1780,0
185000.0,5.0,1.0,1590,1.5,0,1090,500
690000.0,3.0,1.5,1760,2.0,0,1760,0
265000.0,4.0,3.0,1940,1.0,0,1940,0
720000.0,4.0,3.0,3550,1.5,0,2180,1370
256000.0,4.0,2.5,2050,2.0,0,2050,0
255000.0,4.0,2.25,1680,2.0,0,1680,0
540000.0,3.0,2.25,1320,2.0,0,1320,0
481015.0,3.0,2.25,1550,2.0,0,1550,0
575000.0,3.0,1.75,2680,1.0,0,1590,1090
339950.0,3.0,2.5,2390,1.0,0,1840,550
475000.0,4.0,2.5,2040,2.0,0,2040,0
732000.0,3.0,3.75,2670,2.5,4,2020,650
860000.0,4.0,1.75,1880,1.5,0,1880,0
389000.0,4.0,1.75,2400,1.5,0,1500,900
645000.0,3.0,1.75,2270,1.0,0,1370,900
475000.0,4.0,2.5,1850,2.0,0,1850,0
550000.0,4.0,2.75,2160,1.0,0,1430,730
305000.0,2.0,1.0,2160,1.0,0,1360,800
782000.0,2.0,1.5,1570,1.5,2,1320,250
545000.0,3.0,2.0,1340,1.5,0,1340,0
394500.0,4.0,2.5,3002,2.0,0,3002,0
600000.0,5.0,2.0,2190,1.0,0,1110,1080
1300000.0,4.0,1.75,2610,1.0,0,2610,0
300000.0,2.0,1.0,1010,1.0,0,1010,0
330000.0,4.0,2.5,2105,2.0,0,2105,0
723000.0,4.0,2.25,2430,1.5,0,1630,800
480000.0,5.0,2.5,2160,2.0,0,2160,0
496000.0,2.0,1.0,900,1.0,0,900,0
625000.0,3.0,3.0,1820,3.0,0,1540,280
475000.0,4.0,2.0,2100,1.0,0,1050,1050
275250.0,3.0,2.25,1520,2.0,0,1520,0
253000.0,2.0,1.0,1310,1.0,0,940,370
630000.0,4.0,2.5,2190,1.0,0,1410,780
660500.0,5.0,2.5,2950,1.5,0,1720,1230
262000.0,5.0,1.0,1870,1.0,0,1580,290
552000.0,3.0,2.5,1840,1.0,0,1840,0
736000.0,2.0,1.0,1500,1.0,0,1100,400
355000.0,3.0,1.75,1730,1.5,0,1730,0
305000.0,3.0,1.0,1580,1.0,0,1010,570
484998.0,4.0,2.5,1540,2.0,0,1540,0
1054690.0,4.0,3.5,3390,2.0,0,2610,780
334500.0,2.0,1.5,830,2.0,0,830,0
475000.0,4.0,2.75,2620,2.0,0,2620,0
309780.0,3.0,2.5,2242,2.0,0,2242,0
795000.0,4.0,2.5,2890,2.0,0,2890,0
274500.0,3.0,2.25,1450,2.0,0,1450,0
265050.0,2.0,1.5,800,2.0,0,800,0
567500.0,3.0,2.5,2280,2.0,0,1880,400
285000.0,5.0,2.5,2270,2.0,0,2270,0
445838.0,3.0,2.5,2250,2.0,0,2250,0
304900.0,4.0,1.75,2600,1.0,0,1610,990
940000.0,4.0,2.0,2490,2.0,0,2490,0
1127000.0,4.0,2.5,3160,2.0,0,3160,0
290000.0,3.0,1.0,1440,1.0,0,1440,0
250000.0,3.0,1.75,1770,1.0,0,1770,0
342000.0,4.0,2.5,2300,2.0,0,2300,0
1012000.0,4.0,2.5,2980,2.0,0,2980,0
400000.0,4.0,2.25,2230,1.0,0,1300,930
312500.0,3.0,1.75,1830,1.0,0,930,900
267000.0,3.0,1.0,1740,1.0,0,1020,720
575000.0,3.0,1.75,1530,1.0,0,1410,120
810000.0,3.0,1.5,1520,1.0,0,1520,0
850000.0,3.0,2.5,3230,2.0,2,2430,800
1015000.0,3.0,3.25,3620,2.0,0,2730,890
240000.0,3.0,1.75,1570,1.0,0,1570,0
198000.0,4.0,1.75,2080,1.0,0,1050,1030
565000.0,4.0,2.5,2230,1.0,0,1430,800
1195000.0,5.0,3.0,3420,2.0,0,2540,880
815000.0,4.0,2.5,3150,2.0,0,3150,0
588000.0,5.0,3.0,2190,2.0,0,1490,700
280500.0,4.0,2.5,1890,2.0,0,1890,0
509000.0,2.0,1.5,1930,2.0,0,1930,0
490600.0,3.0,2.5,3316,2.0,0,3316,0
650000.0,3.0,1.5,1380,1.0,0,1380,0
715000.0,3.0,4.0,2080,3.0,4,2080,0
529950.0,3.0,1.0,1240,1.5,0,1240,0
265000.0,3.0,1.0,1020,1.0,0,1020,0
1140000.0,3.0,2.5,2780,1.5,1,2110,670
610000.0,3.0,2.0,2300,1.0,0,1430,870
554729.0,4.0,2.5,2020,2.0,0,1730,290
395000.0,5.0,1.75,1840,1.0,2,1360,480
341000.0,3.0,1.0,1390,1.5,0,1390,0
264500.0,4.0,2.25,2060,1.0,0,1200,860
395000.0,4.0,2.75,2640,1.5,0,2640,0
640000.0,3.0,2.25,1980,1.0,0,1980,0
430000.0,3.0,1.5,1810,1.0,0,1030,780
410000.0,4.0,2.5,1700,1.0,0,1700,0
220000.0,4.0,1.0,1200,1.5,0,1200,0
405500.0,2.0,2.75,1350,2.0,0,1120,230
633000.0,4.0,2.5,2360,1.0,3,1980,380
295950.0,2.0,1.0,1190,1.0,0,1190,0
605000.0,4.0,2.5,2800,1.0,0,1420,1380
255000.0,2.0,1.5,920,2.0,0,920,0
474000.0,3.0,1.75,1530,2.0,0,1530,0
370000.0,2.0,1.0,860,1.0,0,860,0
288000.0,3.0,2.5,1520,2.0,0,1520,0
100000.0,2.0,0.75,660,1.0,0,660,0
1150000.0,5.0,2.5,3580,2.0,0,3580,0
600000.0,5.0,2.25,3000,2.0,0,3000,0
515000.0,5.0,3.25,2740,1.0,0,1390,1350
345000.0,4.0,2.5,2040,2.0,0,2040,0
850000.0,3.0,2.0,2470,2.0,0,2470,0
439990.0,3.0,2.5,1930,2.0,0,1300,630
554950.0,3.0,2.5,2950,2.0,0,2950,0
605000.0,3.0,2.5,2610,2.0,0,2610,0
609000.0,3.0,1.75,1630,3.0,0,1630,0
425000.0,3.0,1.5,1400,3.0,0,1400,0
399900.0,2.0,1.75,1410,1.5,0,900,510
519995.0,4.0,3.0,2590,2.0,0,2590,0
625000.0,3.0,1.5,1300,1.0,0,1300,0
600000.0,3.0,2.5,2320,2.0,0,2320,0
1200000.0,4.0,2.5,2700,2.0,0,2700,0
671000.0,4.0,3.0,3130,1.5,0,1750,1380
459500.0,3.0,1.75,1470,1.0,0,1030,440
499000.0,3.0,2.5,1540,3.0,0,1390,150
1280000.0,4.0,2.5,3160,1.5,4,2020,1140
395000.0,3.0,1.75,1480,1.0,0,1480,0
861990.0,5.0,2.75,3595,2.0,0,3595,0
382500.0,2.0,1.0,1190,1.0,0,1190,0
530000.0,3.0,1.75,1320,1.0,0,870,450
195000.0,2.0,1.0,1190,1.0,0,1190,0
747500.0,4.0,2.25,2350,2.0,0,2350,0
199990.0,3.0,1.0,1100,1.0,0,1100,0
548800.0,4.0,1.0,1660,1.5,0,1260,400
870000.0,4.0,3.0,3040,1.5,0,2680,360
588000.0,3.0,2.0,1860,2.0,0,1860,0
445000.0,2.0,2.0,1240,2.0,0,1240,0
300000.0,4.0,3.0,2200,1.0,0,2200,0
480000.0,3.0,2.25,1680,1.0,0,1130,550
300000.0,3.0,1.0,930,1.5,0,930,0
360000.0,3.0,1.5,1800,2.0,0,1800,0
875000.0,3.0,1.5,1820,1.0,0,1820,0
266000.0,4.0,2.25,1995,2.0,0,1995,0
335950.0,2.0,1.5,800,1.0,0,800,0
215000.0,3.0,1.0,960,1.0,0,960,0
481000.0,4.0,2.5,2286,2.0,0,2286,0
320000.0,3.0,1.75,2220,1.0,0,1270,950
295000.0,3.0,1.75,1940,1.5,0,1940,0
295000.0,3.0,1.5,1640,2.0,0,1640,0
320000.0,3.0,1.0,1120,1.0,0,1120,0
780000.0,4.0,2.0,2600,1.0,2,1400,1200
437500.0,3.0,2.0,1490,2.0,0,1490,0
443000.0,5.0,1.75,1650,1.5,0,1650,0
575000.0,4.0,2.5,2400,2.0,0,2400,0
245000.0,2.0,1.0,1500,1.0,0,1190,310
450000.0,3.0,2.5,1990,2.0,0,1990,0
536000.0,2.0,1.5,1130,2.0,0,1030,100
685000.0,3.0,3.25,2030,2.0,0,2030,0
373000.0,4.0,1.75,1590,2.0,0,1590,0
450000.0,3.0,1.75,1480,1.0,0,1480,0
645000.0,4.0,2.5,2690,2.0,0,2690,0
1275000.0,3.0,2.5,3870,2.0,3,3870,0
230000.0,3.0,1.0,1390,1.0,0,1390,0
593000.0,3.0,2.75,1830,2.0,0,1690,140
558000.0,2.0,2.0,1580,1.0,0,790,790
538250.0,3.0,2.25,2590,2.0,3,2590,0
475000.0,5.0,2.5,2510,1.0,0,1490,1020
209950.0,3.0,1.5,1180,1.0,0,1180,0
410000.0,3.0,2.25,1450,2.0,0,1450,0
821000.0,3.0,2.75,2760,1.0,0,1690,1070
665000.0,5.0,2.0,2800,1.0,0,1400,1400
339000.0,3.0,2.5,1450,2.0,0,1450,0
631500.0,4.0,2.0,2530,1.5,0,1910,620
570000.0,3.0,2.0,1640,1.0,3,820,820
437000.0,3.0,1.75,2220,1.0,0,2220,0
542500.0,3.0,2.5,2040,2.0,0,2040,0
229500.0,3.0,1.0,1230,1.0,0,1230,0
170500.0,2.0,1.0,1060,1.0,0,820,240
391500.0,3.0,2.5,1920,2.0,0,1920,0
296475.0,3.0,2.5,1520,2.0,0,1520,0
888550.0,3.0,2.5,3540,2.0,0,3540,0
328000.0,3.0,2.0,2250,1.5,0,2250,0
300000.0,4.0,2.5,2090,2.0,0,2090,0
500000.0,3.0,2.5,1720,2.0,0,1720,0
494815.0,3.0,2.5,1910,2.0,0,1910,0
378000.0,3.0,2.5,1601,3.0,0,1536,65
505000.0,2.0,2.25,1060,2.0,0,940,120
680000.0,4.0,2.75,2330,2.0,0,2330,0
351999.0,3.0,2.5,2370,2.0,0,2370,0
510000.0,3.0,2.5,1420,3.0,0,1420,0
1300000.0,4.0,2.25,2360,2.0,0,2360,0
374000.0,2.0,1.5,1260,2.0,0,1260,0
509900.0,3.0,2.5,3030,2.0,0,3030,0
230000.0,3.0,1.75,1140,2.0,0,1140,0
527700.0,5.0,2.5,2820,1.0,0,1550,1270
438000.0,2.0,2.0,1270,3.0,0,1270,0
900000.0,3.0,2.5,3180,2.0,0,3180,0
1131000.0,3.0,2.25,2790,1.0,3,2790,0
439000.0,4.0,2.25,2570,2.0,0,2570,0
315000.0,2.0,1.0,1080,1.0,0,720,360
765000.0,4.0,4.0,3010,2.0,0,3010,0
332000.0,3.0,2.25,2120,1.0,0,1720,400
600000.0,3.0,2.25,1900,1.5,0,1440,460
378500.0,3.0,2.5,2860,2.0,0,2860,0
190000.0,3.0,1.0,910,1.0,0,910,0
645000.0,4.0,2.5,2850,2.0,0,2850,0
780000.0,2.0,2.5,2560,2.0,0,1690,870
370000.0,3.0,1.75,1570,2.0,0,1570,0
479000.0,3.0,1.0,1340,1.0,0,1340,0
245000.0,4.0,2.25,2600,1.0,0,1390,1210
542000.0,3.0,1.75,1070,1.0,0,1070,0
557500.0,3.0,2.25,1820,2.0,0,1820,0
480000.0,2.0,1.0,1060,1.0,0,860,200
330000.0,3.0,2.25,2220,1.0,0,1330,890
160000.0,3.0,1.0,1350,1.5,0,1350,0
695500.0,5.0,2.75,2510,1.0,1,1600,910
235500.0,5.0,2.5,2340,1.0,0,1670,670
326500.0,3.0,1.0,1060,1.0,0,1060,0
300000.0,4.0,2.5,2200,2.0,0,2200,0
267000.0,3.0,1.0,1400,1.5,0,1400,0
292600.0,3.0,1.5,1520,1.0,0,1520,0
362000.0,5.0,3.0,1810,2.0,0,1810,0
1087500.0,2.0,2.0,2360,1.5,0,2360,0
357562.0,2.0,1.75,1210,2.0,0,1210,0
513000.0,3.0,2.5,1810,2.0,0,1810,0
336000.0,3.0,2.25,2760,1.0,0,2760,0
560000.0,4.0,2.25,1950,1.0,0,1330,620
410000.0,4.0,2.25,2060,1.0,0,1220,840
371500.0,3.0,1.0,1650,1.0,0,980,670
368000.0,4.0,1.75,2100,1.0,0,1030,1070
308950.0,4.0,2.5,1920,2.0,2,1920,0
630000.0,2.0,2.5,2290,2.0,0,2290,0
228950.0,3.0,1.75,1200,1.0,0,1200,0
245000.0,3.0,2.5,1600,2.0,0,1600,0
410000.0,4.0,2.5,2560,2.0,0,2560,0
427550.0,2.0,1.0,880,1.0,0,880,0
235000.0,2.0,1.0,1020,1.0,0,1020,0
210000.0,3.0,2.0,960,1.0,0,960,0
485000.0,4.0,2.25,1900,1.0,0,1370,530
410000.0,3.0,2.0,1320,1.5,0,1320,0
435000.0,4.0,2.75,2230,1.0,0,1320,910
300000.0,3.0,1.0,1150,1.0,0,1150,0
455000.0,4.0,3.5,3440,2.0,0,3440,0
210000.0,3.0,1.0,1070,1.0,0,1070,0
1050000.0,4.0,2.75,2250,1.5,0,1500,750
458400.0,4.0,2.5,1910,1.0,0,1910,0
390000.0,3.0,1.75,1180,1.0,0,1180,0
148226.0,3.0,1.0,1400,1.0,0,1400,0
711600.0,4.0,3.0,3580,2.5,0,2370,1210
819000.0,3.0,2.75,3176,2.0,3,2726,450
613000.0,2.0,2.0,1170,1.5,1,1170,0
592350.0,2.0,2.0,1570,1.0,0,1570,0
232000.0,3.0,1.5,1460,1.0,0,1460,0
250000.0,3.0,1.75,1140,1.0,0,1140,0
115000.0,1.0,2.0,1150,1.0,0,1150,0
1115000.0,4.0,2.5,3180,1.0,0,2390,790
585000.0,4.0,2.5,2630,2.0,0,2630,0
580000.0,3.0,2.25,1940,1.0,0,1520,420
165000.0,1.0,1.0,850,1.0,0,850,0
430000.0,3.0,2.0,1550,1.0,0,830,720
383000.0,3.0,2.25,2090,1.0,0,2090,0
1195000.0,4.0,3.5,3960,2.0,0,2850,1110
201500.0,3.0,1.0,1320,1.5,0,1320,0
690000.0,4.0,2.5,3220,2.0,0,3220,0
325000.0,2.0,1.0,800,1.0,0,800,0
375000.0,3.0,1.75,1660,1.0,0,1130,530
600000.0,4.0,2.5,2250,2.0,0,2250,0
340000.0,3.0,2.25,2120,1.0,0,2120,0
890000.0,4.0,2.75,2310,3.0,0,2310,0
415000.0,4.0,1.75,1920,2.0,0,1920,0
255000.0,3.0,1.75,1550,1.0,0,1050,500
530000.0,2.0,2.5,1785,2.0,0,1595,190
468000.0,3.0,1.5,1830,1.0,0,1830,0
970000.0,5.0,2.75,3500,2.0,2,2950,550
599000.0,3.0,2.0,2560,1.0,0,1330,1230
399500.0,4.0,1.75,1360,1.5,0,1360,0
1205000.0,4.0,3.5,3150,2.0,0,3150,0
325000.0,2.0,1.0,810,1.0,0,810,0
568000.0,4.0,1.75,2790,1.0,2,1450,1340
517000.0,2.0,1.5,1920,1.0,0,960,960
469950.0,4.0,2.75,2530,2.0,0,2530,0
623000.0,3.0,1.75,2050,1.0,0,2050,0
720000.0,4.0,2.25,2410,2.0,0,2410,0
205000.0,3.0,1.0,1180,1.0,0,1180,0
148000.0,2.0,1.0,630,1.0,0,630,0
405000.0,3.0,1.5,1010,1.5,0,1010,0
293000.0,3.0,2.25,1910,2.0,0,1910,0
550000.0,3.0,3.5,2490,2.0,0,1720,770
435000.0,4.0,2.5,2150,2.0,0,2150,0
355000.0,4.0,2.75,3000,2.0,0,3000,0
673000.0,3.0,2.75,2830,2.0,0,2830,0
449990.0,4.0,2.5,2680,2.0,0,2680,0
249000.0,2.0,1.5,1090,2.0,0,1090,0
380000.0,4.0,2.5,1984,1.0,0,1564,420
760005.0,4.0,2.75,3090,2.0,0,3090,0
674600.0,4.0,2.5,2610,2.0,0,2610,0
812000.0,4.0,3.5,3370,2.0,0,2750,620
333490.0,4.0,2.5,2250,2.0,0,2250,0
320000.0,3.0,3.25,1450,2.0,0,1180,270
999000.0,4.0,2.5,3130,2.0,0,3130,0
810000.0,2.0,2.75,2700,1.0,0,2700,0
399950.0,5.0,2.75,1970,1.0,0,1320,650
550000.0,3.0,2.0,1970,2.0,3,1270,700
290000.0,3.0,1.5,1950,1.0,0,1950,0
232500.0,3.0,1.5,1940,1.0,0,1140,800
565000.0,3.0,2.5,2500,2.0,0,2500,0
749950.0,4.0,2.75,2910,1.0,0,2210,700
720500.0,4.0,2.5,3350,2.0,0,3350,0
507000.0,3.0,1.75,2140,1.0,0,1490,650
463000.0,4.0,2.5,1980,2.0,0,1980,0
310000.0,3.0,1.5,1460,1.0,0,1460,0
284000.0,4.0,1.75,1880,1.0,0,1130,750
737500.0,3.0,1.75,2320,2.0,0,2320,0
569000.0,3.0,3.25,2220,1.5,0,1770,450
700000.0,3.0,1.0,1410,2.0,0,1410,0
660000.0,3.0,1.0,1240,1.0,0,1240,0
275000.0,4.0,2.0,2030,2.0,0,2030,0
150000.0,3.0,0.75,490,1.5,0,490,0
356000.0,3.0,2.5,1590,2.0,0,1590,0
610000.0,3.0,2.5,2630,2.0,0,2630,0
498800.0,2.0,1.75,1350,1.0,0,1350,0
226550.0,3.0,1.0,990,1.0,0,990,0
692500.0,4.0,2.75,3710,2.0,0,3710,0
250000.0,3.0,1.0,990,1.0,0,990,0
660000.0,4.0,2.5,2510,2.0,0,2510,0
295000.0,2.0,1.0,800,1.0,0,800,0
154950.0,4.0,1.0,1600,1.0,0,1600,0
409124.0,5.0,3.25,3320,2.0,0,2480,840
287000.0,5.0,1.5,1730,1.0,0,1010,720
810000.0,4.0,1.75,2000,1.0,4,1000,1000
525000.0,4.0,2.75,2910,1.0,0,1640,1270
525000.0,4.0,1.75,1710,1.0,0,1710,0
275000.0,3.0,1.0,1200,1.0,0,1200,0
583000.0,3.0,2.5,2600,2.0,1,2600,0
237950.0,2.0,1.75,1460,1.0,0,1460,0
679000.0,4.0,2.75,2100,1.5,0,1780,320
410000.0,3.0,1.75,1660,1.0,0,830,830
306000.0,3.0,1.0,1450,1.0,0,1010,440
215000.0,4.0,1.5,1860,1.5,0,1860,0
594950.0,4.0,2.5,2720,2.0,0,2720,0
1250000.0,4.0,2.5,2920,1.0,3,2030,890
305000.0,3.0,1.5,1800,1.0,0,1800,0
425000.0,2.0,1.0,1320,1.0,0,1020,300
215000.0,3.0,1.75,1770,1.0,0,1770,0
480000.0,5.0,2.75,2550,1.0,0,1390,1160
550000.0,4.0,1.75,2150,1.0,0,1110,1040
750000.0,4.0,2.5,3020,2.0,0,3020,0
137124.0,3.0,1.0,960,1.0,0,960,0
840000.0,3.0,2.0,2783,2.0,0,2783,0
624800.0,3.0,2.0,2250,1.0,0,1500,750
630000.0,3.0,1.75,1710,1.0,0,1710,0
590000.0,3.0,2.5,2650,1.0,0,1680,970
599950.0,3.0,3.25,1830,3.0,0,1830,0
299880.0,3.0,2.5,1460,2.0,0,1460,0
400000.0,3.0,2.0,1760,1.0,0,1760,0
560000.0,3.0,2.5,1960,2.0,0,1960,0
229000.0,4.0,2.25,2010,1.0,0,1170,840
525000.0,4.0,2.5,3670,2.0,0,3670,0
737000.0,2.0,2.25,2290,1.0,0,2290,0
680000.0,3.0,2.0,1780,1.0,0,980,800
635000.0,4.0,2.5,3080,2.0,0,3080,0
740000.0,4.0,2.5,3360,2.0,0,3360,0
335500.0,3.0,1.0,1370,2.0,0,1370,0
270000.0,4.0,2.5,1660,1.0,0,1660,0
379000.0,3.0,2.5,1530,2.0,0,1530,0
468000.0,4.0,2.5,2100,1.0,0,1240,860
321500.0,1.0,1.0,730,1.0,0,730,0
443000.0,3.0,2.25,1920,2.0,0,1920,0
340000.0,3.0,1.0,1600,1.0,0,1600,0
470000.0,4.0,2.25,2380,2.0,0,1530,850
545000.0,3.0,2.5,2760,2.0,0,2760,0
415000.0,4.0,1.5,1840,1.5,0,1840,0
759000.0,4.0,1.75,2100,1.0,0,1340,760
300000.0,4.0,1.75,1820,1.0,0,1190,630
359000.0,3.0,1.5,1550,1.0,0,1080,470
550000.0,4.0,1.0,1440,1.5,0,1440,0
395000.0,2.0,1.0,930,1.0,0,930,0
486000.0,4.0,2.5,3560,2.0,0,3560,0
187000.0,2.0,1.0,840,1.0,0,840,0
734950.0,4.0,3.25,4280,2.0,0,3050,1230
284000.0,3.0,1.5,1500,1.0,0,1500,0
696000.0,4.0,3.5,3650,2.0,0,2550,1100
380000.0,2.0,1.0,780,1.0,0,780,0
625000.0,4.0,1.0,1600,1.5,0,1600,0
252000.0,4.0,1.75,1120,1.0,0,1120,0
560000.0,2.0,1.0,1010,1.0,0,1010,0
395000.0,4.0,2.75,1970,1.0,0,1970,0
900000.0,4.0,2.5,2230,2.0,0,1540,690
580000.0,3.0,1.75,1850,1.0,0,1020,830
309000.0,3.0,2.25,1980,1.0,0,1300,680
412000.0,4.0,3.5,3360,2.0,0,2450,910
215000.0,3.0,1.0,1200,1.0,0,1200,0
741500.0,2.0,2.5,2150,1.0,0,2150,0
749000.0,3.0,2.75,2820,2.0,0,2820,0
659950.0,4.0,2.75,3510,2.0,0,3510,0
530000.0,3.0,2.5,1790,2.0,0,1790,0
749000.0,4.0,2.75,2700,2.0,0,2100,600
595000.0,4.0,3.25,3730,2.0,0,2760,970
487000.0,4.0,2.5,2540,2.0,0,2540,0
760000.0,4.0,2.25,3300,3.0,0,3300,0
435000.0,4.0,2.5,2550,2.0,0,2550,0
374950.0,3.0,2.25,1390,3.0,0,1390,0
440000.0,3.0,1.5,1270,3.0,0,1270,0
360000.0,4.0,2.5,2380,2.0,0,2380,0
879000.0,4.0,2.5,3360,2.0,0,3360,0
545000.0,2.0,2.0,2930,1.0,2,1680,1250
725000.0,2.0,1.75,1950,1.0,0,1010,940
610000.0,4.0,2.75,2600,1.0,0,1580,1020
350000.0,4.0,1.0,1170,1.5,0,1170,0
410000.0,3.0,1.0,1470,1.0,0,1470,0
639000.0,4.0,2.0,1840,1.0,0,920,920
439000.0,4.0,2.0,1560,1.0,0,1560,0
499950.0,4.0,1.75,1520,1.0,0,1520,0
800000.0,3.0,2.75,2220,2.0,0,1700,520
350000.0,4.0,2.5,2800,2.0,0,2800,0
279000.0,2.0,1.0,670,1.0,0,670,0
290256.0,3.0,2.25,1720,2.0,0,1720,0
355000.0,3.0,2.5,2110,2.0,0,2110,0
263000.0,3.0,1.75,1580,1.0,0,1180,400
426500.0,4.0,2.5,2700,2.0,0,2700,0
735000.0,3.0,2.5,2820,2.0,0,2820,0
720000.0,4.0,2.5,3340,2.0,2,3340,0
265000.0,3.0,2.5,1530,2.0,0,1530,0
657500.0,3.0,2.0,2320,1.0,0,1510,810
850000.0,5.0,2.0,2310,1.5,0,2310,0
436110.0,3.0,2.5,1770,3.0,0,1600,170
620000.0,3.0,1.5,1620,1.0,0,1280,340
254000.0,4.0,2.0,1510,1.0,0,1510,0
375000.0,3.0,1.75,960,1.0,0,960,0
455000.0,4.0,2.25,1740,1.0,0,1170,570
445000.0,4.0,2.0,1470,1.0,0,1470,0
568500.0,4.0,2.5,2460,2.0,0,2460,0
352500.0,3.0,1.75,1170,1.0,0,1170,0
342500.0,2.0,1.75,1210,1.0,0,1210,0
299950.0,3.0,2.5,1870,2.0,0,1870,0
425000.0,3.0,2.5,1950,2.0,0,1950,0
561000.0,4.0,2.5,2570,2.0,0,2570,0
455500.0,3.0,2.0,1460,1.0,0,1460,0
400000.0,3.0,2.5,2970,1.0,0,1510,1460
443500.0,4.0,2.5,2040,2.0,0,2040,0
1234582.0,5.0,3.25,3240,1.5,4,2500,740
475000.0,3.0,2.25,1820,1.0,0,1240,580
580000.0,4.0,2.5,2130,1.0,0,1490,640
518000.0,3.0,1.5,1430,1.0,0,1430,0
525000.0,3.0,2.5,2030,2.0,0,2030,0
236000.0,4.0,2.75,2000,2.0,0,2000,0
278500.0,4.0,2.25,1940,2.0,0,1940,0
205425.0,2.0,1.75,880,1.0,0,880,0
248000.0,3.0,1.0,950,1.0,0,950,0
505000.0,3.0,2.25,1670,2.0,0,1220,450
657500.0,3.0,2.5,2670,2.0,0,2670,0
670000.0,3.0,2.5,2700,2.0,0,1280,1420
202000.0,1.0,1.0,590,1.0,0,590,0
440000.0,4.0,2.25,2160,1.0,0,1080,1080
690000.0,4.0,2.5,2700,2.0,0,2700,0
291000.0,3.0,1.75,1560,1.0,0,1560,0
230000.0,3.0,1.75,1400,1.0,0,1400,0
850000.0,4.0,3.25,3090,2.0,4,3090,0
84350.0,4.0,2.0,2630,2.0,0,2630,0
188000.0,4.0,2.75,3260,1.0,0,2170,1090
237227.857143,4.0,2.5,2200,2.0,0,2200,0
744312.5,4.0,2.5,2800,1.0,0,1660,1140
439333.333333,3.0,3.5,3020,2.0,0,2080,940
280000.0,3.0,2.25,1970,1.0,0,1180,790
176225.0,3.0,2.0,1570,1.0,0,1570,0
500324.0,3.0,2.5,2280,2.0,0,1880,400
444845.0,3.0,2.5,1600,2.0,0,1600,0
330000.0,3.0,3.0,1680,3.0,0,1680,0
292285.714286,3.0,1.75,1890,1.0,0,1890,0
160000.0,2.0,1.0,520,1.0,0,520,0
537500.0,4.0,3.0,2920,1.0,3,1460,1460
237333.333333,3.0,2.75,3010,2.0,0,3010,0
346750.0,3.0,1.0,1620,1.5,0,1620,0
254000.0,3.0,1.5,1770,1.0,0,1160,610
238750.0,3.0,1.0,1830,1.0,0,1830,0
268971.875,4.0,2.5,2380,2.0,0,2380,0
642000.0,4.0,2.5,2550,1.0,0,1290,1260
571986.111111,3.0,2.5,3720,2.0,0,3720,0
554250.0,3.0,2.5,1490,3.0,0,1490,0
300000.0,3.0,2.0,1510,1.0,2,1230,280
540833.333333,3.0,2.0,1640,1.0,0,1640,0
274750.0,4.0,2.5,1840,2.0,0,1400,440
148612.5,3.0,1.0,1040,1.0,0,1040,0
326428.571429,3.0,1.0,1250,1.0,0,1250,0
135333.333333,4.0,1.0,1530,1.5,0,1400,130
577437.5,4.0,2.5,2110,2.0,0,2110,0
440825.0,3.0,1.75,2150,1.0,0,1200,950
257500.0,4.0,1.75,2420,1.0,0,1480,940
176400.0,2.0,1.0,910,1.0,0,910,0
193000.0,3.0,1.5,2200,1.5,0,2200,0
268971.875,4.0,2.5,1860,1.0,0,1220,640
317061.875,3.0,1.75,1280,1.0,0,1280,0
83300.0,3.0,2.0,1490,1.0,0,1490,0
266066.666667,4.0,1.0,1310,1.5,0,1160,150
342246.428571,4.0,2.5,1980,2.0,0,1980,0
240015.333333,4.0,2.25,1720,1.0,0,1720,0
259585.571429,4.0,2.5,1960,2.0,0,1960,0
328211.904762,4.0,2.5,1720,1.0,0,1120,600
673476.818182,4.0,2.5,2740,2.0,0,2740,0
425000.0,3.0,2.5,1870,2.0,0,1870,0
127160.0,2.0,1.0,720,1.0,0,720,0
341750.0,3.0,2.25,2180,2.0,0,2180,0
178650.0,3.0,1.5,1430,1.0,0,1430,0
87500.0,2.0,1.0,780,1.0,0,780,0
282508.888889,3.0,1.0,1180,1.5,0,1180,0
450385.714286,3.0,2.0,1300,1.0,0,900,400
532500.0,2.0,1.75,2050,1.0,0,2050,0
408900.0,3.0,1.75,2930,1.0,0,2030,900
156766.666667,2.0,1.0,1500,1.5,0,880,620
308830.769231,2.0,1.0,810,1.0,0,810,0
484991.666667,4.0,2.75,2320,2.0,0,2320,0
287919.782609,2.0,1.0,1090,1.0,0,730,360
247875.0,2.0,1.0,1000,1.0,0,1000,0
309487.5,3.0,2.5,2260,2.0,0,2260,0
173666.666667,4.0,1.0,1290,1.5,0,1290,0
237481.25,3.0,2.0,2120,1.0,0,2120,0
326983.333333,3.0,2.25,1490,2.0,0,1490,0
790000.0,4.0,2.5,2310,2.0,0,2310,0
678333.333333,3.0,2.5,1840,1.0,0,920,920
542804.75,5.0,2.75,2910,1.0,0,1590,1320
723243.75,4.0,2.75,3270,2.0,0,3270,0
667781.25,5.0,2.75,3040,2.0,0,3040,0
108333.333333,3.0,1.0,1200,1.0,0,1200,0
535000.0,4.0,2.25,2290,2.0,0,2120,170
596165.428571,4.0,2.0,2580,1.0,0,1300,1280
269187.5,3.0,1.75,1590,1.5,0,1590,0
148612.5,3.0,1.0,1040,2.0,0,1040,0
341166.666667,5.0,2.75,2670,2.0,0,2670,0
557125.0,4.0,2.75,3370,2.0,0,3370,0
228944.444444,3.0,1.75,1730,1.0,0,1730,0
592105.714286,3.0,2.5,1640,2.0,0,1640,0
535000.0,4.0,2.25,2980,1.5,2,2020,960
420642.857143,3.0,2.0,1330,1.0,0,1330,0
132250.0,4.0,2.25,2192,2.0,0,2192,0
237227.857143,4.0,2.5,2068,2.0,0,2068,0
440825.0,3.0,1.75,1980,1.0,1,1090,890
423050.925926,2.0,1.0,890,1.0,0,890,0
315368.7,3.0,2.5,3080,2.0,0,3080,0
417985.714286,4.0,2.25,2070,2.0,0,2070,0
723243.75,4.0,2.75,3010,2.0,0,3010,0
259950.0,4.0,2.0,2030,1.0,0,2030,0
237333.333333,3.0,2.75,2340,1.0,0,1500,840
426090.0,3.0,2.5,2340,2.0,0,2340,0
458663.888889,2.0,1.0,1470,1.0,0,1020,450
812650.0,4.0,2.5,3700,1.0,4,2620,1080
135333.333333,4.0,1.0,1200,1.5,0,1200,0
387884.615385,3.0,1.75,1590,1.5,0,970,620
437500.0,5.0,3.5,3690,2.0,0,2540,1150
641633.333333,3.0,2.5,2480,2.0,0,2480,0
681965.78125,4.0,2.5,2683,2.0,0,2683,0
229629.5,2.0,1.0,1100,1.0,0,1100,0
210614.285714,3.0,2.5,2210,1.0,0,1450,760
790000.0,4.0,3.25,2420,1.5,0,1870,550
435500.0,3.0,3.5,1240,2.0,0,1000,240
738190.857143,3.0,2.5,2300,1.5,0,1510,790
497333.333333,3.0,1.75,1760,1.0,0,1230,530
300000.0,3.0,2.0,2020,1.0,0,1220,800
1036200.0,4.0,3.25,2500,1.5,0,1960,540
163785.714286,2.0,1.0,760,1.5,0,760,0
351250.0,4.0,1.75,1580,1.0,0,1130,450
645325.0,3.0,2.5,2670,2.0,0,2670,0
171224.8,3.0,1.0,1140,1.0,0,1140,0
540000.0,3.0,2.75,2750,1.0,2,1810,940
233166.666667,3.0,2.0,1570,2.0,2,1050,520
329333.333333,3.0,1.75,1160,1.0,0,1160,0
225279.428571,3.0,2.25,2110,1.0,0,1360,750
331366.666667,3.0,2.5,1270,2.0,0,1270,0
460886.923077,4.0,2.5,3250,2.0,0,3250,0
337945.75,2.0,1.0,940,1.0,0,940,0
243069.230769,3.0,1.0,1130,1.0,0,1130,0
690408.62069,4.0,2.5,3210,2.0,0,3210,0
592105.714286,3.0,2.5,2650,2.0,0,2650,0
220083.333333,3.0,1.75,1150,1.0,0,1150,0
280000.0,3.0,3.0,3910,2.0,0,3910,0
297857.142857,4.0,2.5,3490,2.0,0,3490,0
950833.333333,5.0,3.0,3330,2.0,0,2610,720
323833.333333,4.0,1.0,1940,1.5,0,1940,0
309000.0,3.0,2.5,1800,2.0,0,1800,0
248400.0,3.0,1.75,1880,1.0,0,1330,550
994500.0,4.0,2.25,2870,1.5,0,1980,890
379509.166667,2.0,1.0,880,1.0,0,880,0
180785.714286,2.0,1.0,2550,1.0,1,1610,940
950100.0,4.0,2.5,3160,2.0,0,3160,0
542500.0,5.0,2.75,3831,2.0,4,3831,0
362750.0,2.0,1.75,1240,1.5,0,1240,0
234975.0,4.0,2.75,2520,2.0,0,2520,0
672500.0,4.0,2.25,2420,2.0,0,2420,0
391400.0,4.0,1.75,1250,1.0,0,1250,0
198995.0,3.0,1.0,1410,1.0,0,1410,0
278900.0,3.0,1.0,990,1.0,0,990,0
171758.333333,3.0,1.0,1000,1.0,0,1000,0
325187.5,3.0,1.75,2000,1.0,0,1300,700
190368.75,2.0,1.0,1120,1.0,0,1120,0
375000.0,5.0,3.25,3370,2.0,0,3370,0
216000.0,3.0,2.75,2210,2.0,0,2210,0
360500.0,3.0,2.5,1150,3.0,0,1150,0
677099.565217,4.0,2.5,2150,2.0,0,2150,0
289987.5,3.0,1.75,1570,1.0,0,1080,490
264270.0,3.0,2.5,1630,1.0,0,1120,510
602761.0,4.0,2.5,2770,2.0,0,2770,0
251555.555556,3.0,1.0,1750,1.0,0,1150,600
214750.0,3.0,1.5,1090,1.0,0,1090,0
258125.0,2.0,1.0,930,1.0,0,930,0
677099.565217,4.0,2.5,2540,2.0,0,2540,0
167500.0,1.0,1.0,690,1.0,0,690,0
471500.0,4.0,3.0,2370,1.5,0,1650,720
464600.0,2.0,1.0,840,1.0,2,840,0
132250.0,4.0,2.25,1830,2.0,0,1830,0
433111.111111,3.0,2.25,1370,3.0,0,1370,0
542500.0,5.0,2.75,2520,1.0,3,1570,950
368112.5,4.0,2.5,2590,2.0,0,2590,0
673476.818182,4.0,2.5,1820,2.0,0,1820,0
558653.846154,3.0,2.5,1530,1.5,0,1010,520
168333.333333,2.0,1.0,1050,1.5,0,1050,0
268971.875,4.0,2.5,1954,2.0,0,1954,0
318000.0,2.0,1.75,1530,1.0,1,830,700
550607.142857,4.0,2.0,1660,1.5,0,1660,0
584000.0,3.0,1.75,1490,2.0,0,1090,400
245000.0,3.0,3.0,2470,2.0,0,1860,610
287919.782609,2.0,1.0,870,1.0,0,870,0
672500.0,4.0,2.25,2110,2.0,0,2110,0
454790.0,2.0,1.75,1990,1.0,0,1090,900
282508.888889,3.0,1.0,1560,1.0,0,910,650
473200.0,3.0,1.5,1740,1.5,0,1640,100
406062.5,2.0,1.0,1290,1.0,0,1290,0
282766.666667,4.0,2.0,1700,1.0,0,850,850
486445.833333,3.0,1.75,1880,1.0,0,1880,0
486895.0,3.0,1.0,1890,1.5,0,1390,500
430277.777778,3.0,2.25,1620,3.0,0,1540,80
229629.5,2.0,1.0,770,1.0,0,770,0
182805.0,3.0,1.0,1040,1.0,0,800,240
380680.555556,4.0,2.5,2620,2.0,0,2620,0
396166.666667,3.0,1.75,1880,1.0,0,940,940
252980.0,4.0,2.5,2530,2.0,0,2530,0
289373.307692,3.0,2.5,2538,2.0,0,2538,0
210614.285714,3.0,2.5,1610,2.0,0,1610,0
308166.666667,3.0,1.75,1510,1.0,0,1510,0
534333.333333,3.0,2.5,1460,2.0,0,1460,0
416904.166667,3.0,2.5,3010,2.0,0,3010,0
203400.0,4.0,2.0,2090,1.0,0,1070,1020
220600.0,3.0,2.5,1490,2.0,0,1490,0
